date,service_hrs,kitchen_hrs,dishwasher_hrs,service_per,kitchen_per,dishwasher_per,total_per,total_hrs
2020-01-01,196,107,52,17,12,3,32,355
2020-01-02,187,121,56,9,8,2,19,364
2020-01-03,225,106,55,15,8,2,25,386
2020-01-04,217,132,56,12,9,2,23,405
2020-01-05,161,104,43,11,9,2,22,308
2020-01-06,118,89,51,12,11,4,27,258
2020-01-07,117,91,48,18,14,4,36,256
2020-01-08,108,75,49,17,13,5,35,232
2020-01-09,117,83,44,17,12,4,33,244
2020-01-10,182,82,43,15,9,3,27,307
2020-01-11,209,107,54,12,8,3,23,370
2020-01-12,149,111,45,12,11,3,26,305
2020-01-13,118,89,50,13,11,3,27,257
2020-01-14,105,82,42,14,12,5,31,229
2020-01-15,108,89,46,12,10,5,27,243
2020-01-16,125,82,38,14,10,3,27,245
2020-01-17,174,84,40,16,9,3,28,298
2020-01-18,189,116,52,11,8,3,22,357
2020-01-19,156,106,45,13,9,3,25,307
2020-01-20,115,93,42,14,12,5,31,250
2020-01-21,118,76,39,15,10,4,29,233
2020-01-22,105,89,39,12,11,4,27,233
2020-01-23,126,83,46,13,9,4,26,255
2020-01-24,159,93,46,12,9,3,24,298
2020-01-25,204,114,52,10,7,3,20,370
2020-01-26,182,101,45,12,8,3,23,328
2020-01-27,109,92,39,12,11,4,27,240
2020-01-28,109,82,45,11,9,4,24,236
2020-01-29,119,89,39,12,11,3,26,247
2020-01-30,138,88,45,11,9,3,23,271
2020-01-31,168,88,53,13,8,4,25,309
2020-02-01,193,108,49,11,7,3,21,350
2020-02-02,157,98,39,13,9,3,25,294
2020-02-03,115,88,50,13,11,5,29,253
2020-02-04,126,79,44,13,9,4,26,249
2020-02-05,115,82,42,14,11,5,30,239
2020-02-06,116,87,54,12,10,5,27,257
2020-02-07,158,101,63,13,9,5,27,322
2020-02-08,197,114,50,11,7,3,21,361
2020-02-09,141,98,47,14,11,4,29,286
2020-02-10,114,92,55,13,12,6,31,261
2020-02-11,137,92,32,14,10,3,27,261
2020-02-12,145,91,54,13,8,4,25,290
2020-02-13,140,87,55,12,9,4,25,282
2020-02-14,150,104,61,9,7,4,20,315
2020-02-15,186,113,63,9,7,3,19,362
2020-02-16,161,108,48,13,9,3,25,317
2020-02-17,130,89,53,14,9,5,28,272
2020-02-18,122,87,39,14,11,4,29,248
2020-02-19,117,89,49,12,10,5,27,255
2020-02-20,121,86,58,12,11,6,29,265
2020-02-21,173,99,49,11,8,3,22,321
2020-02-22,203,115,61,10,7,3,20,379
2020-02-23,163,106,48,10,8,3,21,317
2020-02-24,120,91,60,12,12,6,30,271
2020-02-25,131,85,48,12,10,5,27,264
2020-02-26,119,82,53,13,10,5,28,254
2020-02-27,126,86,42,13,10,4,27,254
2020-02-28,164,99,68,11,10,6,27,331
2020-02-29,199,112,62,11,8,4,23,373
2020-03-01,161,102,47,11,9,4,24,310
2020-03-02,113,81,56,16,13,7,36,250
2020-03-03,110,84,53,13,11,6,30,247
2020-03-04,91,86,52,14,15,8,37,229
2020-03-05,127,83,53,15,11,6,32,263
2020-03-06,152,104,57,12,10,4,26,313
2020-03-07,167,111,56,9,7,3,19,334
2020-03-08,151,108,47,11,9,3,23,306
2020-03-09,102,88,43,13,13,5,31,233
2020-03-10,91,73,51,16,14,8,38,215
2020-03-11,89,61,48,11,9,6,26,198
2020-03-12,94,74,44,15,12,6,33,212
2020-03-13,98,72,41,16,12,6,34,211
2020-03-14,87,73,37,12,10,4,26,197
2020-03-15,50,55,25,24,27,10,61,130
2020-03-16,5,0,0,0,0,0,0,5
2020-03-17,0,0,0,0,0,0,0,0
2020-03-18,0,0,0,0,0,0,0,0
2020-03-19,0,0,0,0,0,0,0,0
2020-03-20,0,0,0,0,0,0,0,0
2020-03-21,0,0,0,0,0,0,0,0
2020-03-22,0,0,0,0,0,0,0,0
2020-03-23,0,0,0,0,0,0,0,0
2020-03-24,0,0,0,0,0,0,0,0
2020-03-25,0,0,0,0,0,0,0,0
2020-03-26,0,0,0,0,0,0,0,0
2020-03-27,0,0,0,0,0,0,0,0
2020-03-28,0,0,0,0,0,0,0,0
2020-03-29,0,0,0,0,0,0,0,0
2020-03-30,0,0,0,0,0,0,0,0
2020-03-31,0,0,0,0,0,0,0,0
2020-04-01,0,0,0,0,0,0,0,0
2020-04-02,0,0,0,0,0,0,0,0
2020-04-03,0,0,0,0,0,0,0,0
2020-04-04,0,0,0,0,0,0,0,0
2020-04-05,0,0,0,0,0,0,0,0
2020-04-06,0,0,0,0,0,0,0,0
2020-04-07,0,0,0,0,0,0,0,0
2020-04-08,0,0,0,0,0,0,0,0
2020-04-09,0,0,0,0,0,0,0,0
2020-04-10,0,0,0,0,0,0,0,0
2020-04-11,0,0,0,0,0,0,0,0
2020-04-12,0,0,0,0,0,0,0,0
2020-04-13,0,0,0,0,0,0,0,0
2020-04-14,0,0,0,0,0,0,0,0
2020-04-15,0,0,0,0,0,0,0,0
2020-04-16,0,0,0,0,0,0,0,0
2020-04-17,0,0,0,0,0,0,0,0
2020-04-18,0,0,0,0,0,0,0,0
2020-04-19,0,0,0,0,0,0,0,0
2020-04-20,0,0,0,0,0,0,0,0
2020-04-21,0,0,0,0,0,0,0,0
2020-04-22,0,0,0,0,0,0,0,0
2020-04-23,0,0,0,0,0,0,0,0
2020-04-24,0,0,0,0,0,0,0,0
2020-04-25,0,0,0,0,0,0,0,0
2020-04-26,0,0,0,0,0,0,0,0
2020-04-27,0,0,0,0,0,0,0,0
2020-04-28,0,0,0,0,0,0,0,0
2020-04-29,0,0,0,0,0,0,0,0
2020-04-30,0,0,0,0,0,0,0,0
2020-05-01,0,0,0,0,0,0,0,0
2020-05-02,0,0,0,0,0,0,0,0
2020-05-03,6,0,0,0,0,0,0,6
2020-05-04,0,0,0,0,0,0,0,0
2020-05-05,0,0,0,0,0,0,0,0
2020-05-06,0,0,0,0,0,0,0,0
2020-05-07,0,0,0,0,0,0,0,0
2020-05-08,0,0,0,0,0,0,0,0
2020-05-09,0,0,0,0,0,0,0,0
2020-05-10,0,0,0,0,0,0,0,0
2020-05-11,0,0,0,0,0,0,0,0
2020-05-12,0,0,0,0,0,0,0,0
2020-05-13,0,0,0,0,0,0,0,0
2020-05-14,0,3,0,0,0,0,0,3
2020-05-15,0,0,0,0,0,0,0,0
2020-05-16,0,0,4,0,0,0,0,4
2020-05-17,0,0,0,0,0,0,0,0
2020-05-18,0,0,0,0,0,0,0,0
2020-05-19,0,0,0,0,0,0,0,0
2020-05-20,0,0,0,0,0,0,0,0
2020-05-21,0,0,0,0,0,0,0,0
2020-05-22,0,0,0,0,0,0,0,0
2020-05-23,0,0,0,0,0,0,0,0
2020-05-24,0,0,0,0,0,0,0,0
2020-05-25,0,0,0,0,0,0,0,0
2020-05-26,0,0,0,0,0,0,0,0
2020-05-27,0,0,0,0,0,0,0,0
2020-05-28,0,0,0,0,0,0,0,0
2020-05-29,0,0,0,0,0,0,0,0
2020-05-30,0,0,0,0,0,0,0,0
2020-05-31,0,5,0,0,0,0,0,5
2020-06-01,108,68,9,30,20,2,52,185
2020-06-02,78,53,6,28,20,1,49,137
2020-06-03,57,51,6,21,17,2,40,114
2020-06-04,58,53,7,22,17,2,41,118
2020-06-05,57,59,13,20,19,3,42,129
2020-06-06,59,66,14,15,16,3,34,139
2020-06-07,51,62,7,16,19,2,37,120
2020-06-08,49,52,13,21,22,4,47,114
2020-06-09,41,44,14,21,24,6,51,99
2020-06-10,56,47,8,16,15,2,33,111
2020-06-11,58,49,7,16,12,1,29,114
2020-06-12,62,58,18,14,12,3,29,138
2020-06-13,77,68,17,12,10,2,24,162
2020-06-14,52,56,14,15,16,3,34,122
2020-06-15,43,60,12,17,25,3,45,115
2020-06-16,43,48,15,17,20,5,42,106
2020-06-17,48,48,16,17,16,4,37,112
2020-06-18,49,59,14,17,21,4,42,122
2020-06-19,69,55,17,15,12,3,30,141
2020-06-20,69,69,16,10,12,2,24,154
2020-06-21,65,63,20,12,11,3,26,148
2020-06-22,52,52,16,18,17,4,39,120
2020-06-23,94,26,0,26,8,0,34,120
2020-06-24,105,16,0,24,5,0,29,121
2020-06-25,137,3,0,34,1,0,35,140
2020-06-26,144,0,0,21,0,0,21,144
2020-06-27,141,26,7,18,4,1,23,174
2020-06-28,72,54,21,12,9,3,24,147
2020-06-29,42,64,6,17,24,2,43,112
2020-06-30,54,36,9,19,12,2,33,99
2020-07-01,66,57,16,14,12,3,29,139
2020-07-02,65,70,14,14,16,2,32,149
2020-07-03,85,63,33,12,10,4,26,181
2020-07-04,116,70,30,12,8,3,23,216
2020-07-05,99,64,29,12,9,3,24,192
2020-07-06,55,64,14,13,17,3,33,133
2020-07-07,76,46,15,16,11,2,29,137
2020-07-08,53,55,21,18,17,5,40,129
2020-07-09,61,66,13,15,17,3,35,140
2020-07-10,91,61,27,13,8,3,24,179
2020-07-11,126,74,35,12,8,3,23,235
2020-07-12,100,68,31,12,10,3,25,199
2020-07-13,80,63,16,13,11,2,26,159
2020-07-14,76,50,15,14,10,2,26,141
2020-07-15,74,61,16,15,12,2,29,151
2020-07-16,69,68,14,12,12,2,26,151
2020-07-17,107,65,27,13,9,3,25,199
2020-07-18,154,62,26,14,7,2,23,242
2020-07-19,105,64,32,11,8,3,22,201
2020-07-20,80,68,15,12,11,2,25,163
2020-07-21,83,47,14,14,8,2,24,144
2020-07-22,75,63,14,13,11,2,26,152
2020-07-23,84,70,14,15,13,2,30,168
2020-07-24,93,55,33,12,9,3,24,181
2020-07-25,125,69,36,11,8,2,21,230
2020-07-26,102,59,30,13,9,3,25,191
2020-07-27,70,57,25,13,13,3,29,152
2020-07-28,86,54,27,13,9,2,24,167
2020-07-29,90,64,26,14,11,2,27,180
2020-07-30,90,65,25,11,11,2,24,180
2020-07-31,124,61,28,12,8,3,23,213
2020-08-01,156,58,37,12,7,3,22,251
2020-08-02,91,57,34,11,8,4,23,182
2020-08-03,72,57,24,14,13,4,31,153
2020-08-04,82,53,25,12,9,3,24,160
2020-08-05,94,61,24,17,11,3,31,179
2020-08-06,84,68,24,15,14,4,33,176
2020-08-07,90,64,35,13,10,4,27,189
2020-08-08,129,66,44,13,7,4,24,239
2020-08-09,109,70,27,14,11,3,28,206
2020-08-10,81,73,19,13,12,3,28,173
2020-08-11,93,49,26,13,8,3,24,168
2020-08-12,157,11,12,24,3,1,28,180
2020-08-13,126,36,13,20,7,2,29,175
2020-08-14,116,57,33,14,8,3,25,206
2020-08-15,139,72,43,13,8,4,25,254
2020-08-16,91,66,26,13,10,3,26,183
2020-08-17,72,65,18,15,15,3,33,155
2020-08-18,75,56,24,16,13,4,33,155
2020-08-19,91,64,24,17,15,4,36,179
2020-08-20,69,68,25,11,12,3,26,162
2020-08-21,106,68,33,12,12,4,28,207
2020-08-22,120,72,40,11,10,4,25,232
2020-08-23,101,61,26,17,11,4,32,188
2020-08-24,61,62,24,13,15,4,32,147
2020-08-25,70,49,23,17,13,4,34,142
2020-08-26,78,48,23,20,12,4,36,149
2020-08-27,67,56,23,14,12,4,30,146
2020-08-28,104,53,33,14,8,4,26,190
2020-08-29,109,70,40,12,9,4,25,219
2020-08-30,102,50,26,18,10,4,32,178
2020-08-31,66,62,34,15,16,5,36,162
2020-09-01,69,42,30,16,10,5,31,141
2020-09-02,67,53,34,20,17,7,44,154
2020-09-03,61,54,35,16,13,7,36,150
2020-09-04,108,66,44,15,10,5,30,218
2020-09-05,114,70,43,14,9,4,27,227
2020-09-06,86,58,32,14,10,5,29,176
2020-09-07,67,50,26,18,14,5,37,143
2020-09-08,58,47,27,14,13,5,32,132
2020-09-09,58,47,22,16,14,5,35,127
2020-09-10,65,49,25,16,12,5,33,139
2020-09-11,95,58,26,15,9,3,27,179
2020-09-12,112,67,37,12,8,3,23,216
2020-09-13,86,55,32,15,10,5,30,173
2020-09-14,65,55,24,13,13,4,30,144
2020-09-15,68,48,25,14,11,4,29,141
2020-09-16,57,52,24,18,17,6,41,133
2020-09-17,72,55,24,18,14,5,37,151
2020-09-18,90,62,28,16,12,4,32,180
2020-09-19,107,73,28,13,9,3,25,208
2020-09-20,68,61,25,15,14,5,34,154
2020-09-21,53,57,20,18,21,5,44,130
2020-09-22,56,50,16,13,13,3,29,122
2020-09-23,46,48,15,17,20,5,42,109
2020-09-24,52,58,16,13,15,3,31,126
2020-09-25,76,59,22,14,13,4,31,157
2020-09-26,102,74,27,11,9,2,22,203
2020-09-27,64,56,17,13,12,3,28,137
2020-09-28,52,50,16,26,25,6,57,118
2020-09-29,38,52,13,18,25,4,47,103
2020-09-30,42,40,11,19,18,4,41,93
2020-10-01,39,38,15,22,24,7,53,92
2020-10-02,65,46,19,18,14,4,36,130
2020-10-03,63,45,23,13,10,4,27,131
2020-10-04,57,50,34,17,15,8,40,141
2020-10-05,28,42,12,14,20,4,38,82
2020-10-06,38,41,5,21,24,2,47,84
2020-10-07,40,40,12,24,24,5,53,92
2020-10-08,34,41,11,13,17,4,34,86
2020-10-09,57,39,13,17,12,3,32,109
2020-10-10,68,58,22,14,12,3,29,148
2020-10-11,52,51,15,12,11,3,26,118
2020-10-12,35,44,12,15,19,4,38,91
2020-10-13,43,43,12,12,12,3,27,98
2020-10-14,62,44,11,15,11,2,28,117
2020-10-15,16,6,8,0,0,0,0,30
2020-10-16,35,6,11,0,0,0,0,52
2020-10-17,6,0,0,0,0,0,0,6
2020-10-18,0,0,0,0,0,0,0,0
2020-10-19,0,0,0,0,0,0,0,0
2020-10-20,0,0,0,0,0,0,0,0
2020-10-21,0,0,0,0,0,0,0,0
2020-10-22,6,0,0,0,0,0,0,6
2020-10-23,0,0,0,0,0,0,0,0
2020-10-24,0,0,0,0,0,0,0,0
2020-10-25,5,0,0,0,0,0,0,5
2020-10-26,4,0,0,0,0,0,0,4
2020-10-27,0,0,0,0,0,0,0,0
2020-10-28,0,0,0,0,0,0,0,0
2020-10-29,6,3,0,0,0,0,0,9
2020-10-30,4,0,0,0,0,0,0,4
2020-10-31,0,0,0,0,0,0,0,0
2020-11-01,4,0,0,0,0,0,0,4
2020-11-02,0,0,0,0,0,0,0,0
2020-11-03,0,0,0,0,0,0,0,0
2020-11-04,0,0,0,0,0,0,0,0
2020-11-05,9,0,0,0,0,0,0,9
2020-11-06,0,0,0,0,0,0,0,0
2020-11-07,0,0,0,0,0,0,0,0
2020-11-08,2,0,0,50,0,0,50,2
2020-11-09,0,0,0,0,0,0,0,0
2020-11-10,0,0,0,0,0,0,0,0
2020-11-11,0,0,0,0,0,0,0,0
2020-11-12,0,0,0,0,0,0,0,0
2020-11-13,0,0,0,0,0,0,0,0
2020-11-14,2,0,0,0,0,0,0,2
2020-11-15,0,0,0,0,0,0,0,0
2020-11-16,0,0,0,0,0,0,0,0
2020-11-17,0,0,0,0,0,0,0,0
2020-11-18,4,0,0,0,0,0,0,4
2020-11-19,2,0,0,0,0,0,0,2
2020-11-20,4,0,0,0,0,0,0,4
2020-11-21,0,0,0,0,0,0,0,0
2020-11-22,0,0,0,0,0,0,0,0
2020-11-23,0,0,0,0,0,0,0,0
2020-11-24,0,0,0,0,0,0,0,0
2020-11-25,0,0,0,0,0,0,0,0
2020-11-26,0,0,0,0,0,0,0,0
2020-11-27,0,0,0,0,0,0,0,0
2020-11-28,3,0,0,0,0,0,0,3
2020-11-29,0,0,0,0,0,0,0,0
2020-11-30,0,0,0,0,0,0,0,0
2020-12-01,0,0,0,0,0,0,0,0
2020-12-02,0,0,0,0,0,0,0,0
2020-12-03,0,0,0,0,0,0,0,0
2020-12-04,0,0,0,0,0,0,0,0
2020-12-05,0,0,0,0,0,0,0,0
2020-12-06,0,0,0,0,0,0,0,0
2020-12-07,0,0,0,0,0,0,0,0
2020-12-08,0,0,0,0,0,0,0,0
2020-12-09,0,0,0,0,0,0,0,0
2020-12-10,0,0,0,0,0,0,0,0
2020-12-11,3,0,0,0,0,0,0,3
2020-12-12,1,0,0,0,0,0,0,1
2020-12-13,0,0,0,0,0,0,0,0
2020-12-14,0,0,0,0,0,0,0,0
2020-12-15,0,0,0,0,0,0,0,0
2020-12-16,0,0,0,0,0,0,0,0
2020-12-17,3,0,0,0,0,0,0,3
2020-12-18,11,8,12,0,0,0,0,31
2020-12-19,2,0,0,0,0,0,0,2
2020-12-20,2,0,0,0,0,0,0,2
2020-12-21,0,15,3,0,0,0,0,18
2020-12-22,4,20,0,0,0,0,0,24
2020-12-23,10,65,18,0,0,0,0,93
2020-12-24,9,34,13,0,0,0,0,56
2020-12-25,16,25,6,0,0,0,0,47
2020-12-26,0,6,3,0,0,0,0,9
2020-12-27,0,6,0,0,0,0,0,6
2020-12-28,0,9,0,0,0,0,0,9
2020-12-29,6,12,0,0,0,0,0,18
2020-12-30,6,22,6,0,0,0,0,34
2020-12-31,13,25,6,0,0,0,0,44
2021-01-01,12,2,4,0,0,0,0,18
2021-01-02,0,0,0,0,0,0,0,0
2021-01-03,0,0,0,0,0,0,0,0
2021-01-04,0,0,0,0,0,0,0,0
2021-01-05,6,0,0,0,0,0,0,6
2021-01-06,0,0,0,0,0,0,0,0
2021-01-07,0,0,0,0,0,0,0,0
2021-01-08,4,0,0,0,0,0,0,4
2021-01-09,5,0,0,0,0,0,0,5
2021-01-10,0,0,0,0,0,0,0,0
2021-01-11,4,0,0,0,0,0,0,4
2021-01-12,5,0,0,0,0,0,0,5
2021-01-13,0,0,0,0,0,0,0,0
2021-01-14,0,0,0,0,0,0,0,0
2021-01-15,0,0,0,0,0,0,0,0
2021-01-16,2,0,0,0,0,0,0,2
2021-01-17,0,0,0,0,0,0,0,0
2021-01-18,0,0,0,0,0,0,0,0
2021-01-19,0,0,0,0,0,0,0,0
2021-01-20,0,0,0,0,0,0,0,0
2021-01-21,0,0,0,0,0,0,0,0
2021-01-22,2,0,0,0,0,0,0,2
2021-01-23,1,0,0,0,0,0,0,1
2021-01-24,0,0,0,0,0,0,0,0
2021-01-25,0,0,0,0,0,0,0,0
2021-01-26,0,0,0,0,0,0,0,0
2021-01-27,0,0,0,0,0,0,0,0
2021-01-28,0,0,0,0,0,0,0,0
2021-01-29,1,0,0,0,0,0,0,1
2021-01-30,2,0,0,0,0,0,0,2
2021-01-31,0,0,0,0,0,0,0,0
2021-02-01,0,0,0,0,0,0,0,0
2021-02-02,0,0,0,0,0,0,0,0
2021-02-03,0,0,0,0,0,0,0,0
2021-02-04,0,0,0,0,0,0,0,0
2021-02-05,0,0,0,0,0,0,0,0
2021-02-06,0,0,0,0,0,0,0,0
2021-02-07,0,0,0,0,0,0,0,0
2021-02-08,0,0,0,0,0,0,0,0
2021-02-09,0,0,0,0,0,0,0,0
2021-02-10,0,0,0,0,0,0,0,0
2021-02-11,0,0,0,0,0,0,0,0
2021-02-12,0,0,0,0,0,0,0,0
2021-02-13,0,0,0,0,0,0,0,0
2021-02-14,0,0,0,0,0,0,0,0
2021-02-15,0,0,0,0,0,0,0,0
2021-02-16,0,0,0,0,0,0,0,0
2021-02-17,0,0,0,0,0,0,0,0
2021-02-18,0,0,0,0,0,0,0,0
2021-02-19,0,0,0,0,0,0,0,0
2021-02-20,0,0,0,0,0,0,0,0
2021-02-21,0,0,0,0,0,0,0,0
2021-02-22,0,0,0,0,0,0,0,0
2021-02-23,0,0,0,0,0,0,0,0
2021-02-24,0,0,0,0,0,0,0,0
2021-02-25,0,0,0,0,0,0,0,0
2021-02-26,0,0,0,0,0,0,0,0
2021-02-27,0,0,0,0,0,0,0,0
2021-02-28,0,0,0,0,0,0,0,0
2021-03-01,0,0,0,0,0,0,0,0
2021-03-02,0,0,0,0,0,0,0,0
2021-03-03,0,0,0,0,0,0,0,0
2021-03-04,0,0,0,0,0,0,0,0
2021-03-05,0,0,0,0,0,0,0,0
2021-03-06,0,0,0,0,0,0,0,0
2021-03-07,0,0,0,0,0,0,0,0
2021-03-08,0,0,0,0,0,0,0,0
2021-03-09,0,0,0,0,0,0,0,0
2021-03-10,0,0,0,0,0,0,0,0
2021-03-11,0,0,0,0,0,0,0,0
2021-03-12,0,0,0,0,0,0,0,0
2021-03-13,0,0,0,0,0,0,0,0
2021-03-14,0,0,0,0,0,0,0,0
2021-03-15,0,0,0,0,0,0,0,0
2021-03-16,0,0,0,0,0,0,0,0
2021-03-17,0,0,0,0,0,0,0,0
2021-03-18,0,0,0,0,0,0,0,0
2021-03-19,0,0,0,0,0,0,0,0
2021-03-20,0,0,0,0,0,0,0,0
2021-03-21,0,0,0,0,0,0,0,0
2021-03-22,0,0,0,0,0,0,0,0
2021-03-23,0,0,0,0,0,0,0,0
2021-03-24,0,0,0,0,0,0,0,0
2021-03-25,6,8,6,0,0,0,0,20
2021-03-26,0,0,0,0,0,0,0,0
2021-03-27,2,0,0,0,0,0,0,2
2021-03-28,0,0,0,0,0,0,0,0
2021-03-29,0,0,0,0,0,0,0,0
2021-03-30,0,0,0,0,0,0,0,0
2021-03-31,0,6,0,0,0,0,0,6
2021-04-01,0,0,0,0,0,0,0,0
2021-04-02,0,0,0,0,0,0,0,0
2021-04-03,0,0,0,0,0,0,0,0
2021-04-04,15,8,7,0,0,0,0,30
2021-04-05,1,5,0,0,0,0,0,6
2021-04-06,0,6,6,0,0,0,0,12
2021-04-07,0,0,0,0,0,0,0,0
2021-04-08,0,0,0,0,0,0,0,0
2021-04-09,0,0,0,0,0,0,0,0
2021-04-10,0,0,0,0,0,0,0,0
2021-04-11,0,0,0,0,0,0,0,0
2021-04-12,0,0,0,0,0,0,0,0
2021-04-13,0,0,0,0,0,0,0,0
2021-04-14,0,0,0,0,0,0,0,0
2021-04-15,0,0,0,0,0,0,0,0
2021-04-16,0,6,0,0,0,0,0,6
2021-04-17,0,0,0,0,0,0,0,0
2021-04-18,0,0,0,0,0,0,0,0
2021-04-19,0,0,0,0,0,0,0,0
2021-04-20,0,0,0,0,0,0,0,0
2021-04-21,0,0,0,0,0,0,0,0
2021-04-22,0,0,0,0,0,0,0,0
2021-04-23,0,6,0,0,0,0,0,6
2021-04-24,0,5,0,0,0,0,0,5
2021-04-25,3,0,0,0,0,0,0,3
2021-04-26,6,10,6,0,0,0,0,22
2021-04-27,5,0,0,0,0,0,0,5
2021-04-28,25,18,9,36,25,8,69,52
2021-04-29,18,20,0,239,222,0,461,38
2021-04-30,20,25,8,0,0,0,0,53
2021-05-01,26,39,0,14,19,0,33,65
2021-05-02,22,30,8,15,18,3,36,60
2021-05-03,23,22,17,16,14,8,38,62
2021-05-04,26,14,7,70,34,11,115,47
2021-05-05,21,10,8,65,26,14,105,39
2021-05-06,13,23,0,13,18,0,31,36
2021-05-07,13,31,8,7,15,3,25,52
2021-05-08,18,30,8,15,24,5,44,56
2021-05-09,30,31,10,14,13,3,30,71
2021-05-10,14,20,10,22,34,11,67,44
2021-05-11,11,16,8,10,17,5,32,35
2021-05-12,15,14,8,18,15,6,39,37
2021-05-13,26,29,15,15,18,7,40,70
2021-05-14,28,33,8,12,15,3,30,69
2021-05-15,26,25,8,13,11,3,27,59
2021-05-16,31,22,8,13,10,3,26,61
2021-05-17,32,14,7,35,26,7,68,53
2021-05-18,19,13,8,24,19,6,49,40
2021-05-19,16,25,13,21,37,13,71,54
2021-05-20,22,30,18,11,13,7,31,70
2021-05-21,30,38,9,16,21,4,41,77
2021-05-22,36,27,8,16,12,3,31,71
2021-05-23,25,39,18,11,19,7,37,82
2021-05-24,30,39,10,16,24,4,44,79
2021-05-25,36,21,9,24,17,5,46,66
2021-05-26,24,25,10,18,17,5,40,59
2021-05-27,8,27,14,5,15,6,26,49
2021-05-28,42,34,10,18,15,3,36,86
2021-05-29,25,31,14,6,8,3,17,70
2021-05-30,27,44,16,6,10,3,19,87
2021-05-31,36,37,10,13,14,3,30,83
2021-06-01,41,35,13,18,13,4,35,89
2021-06-02,41,36,13,17,14,5,36,90
2021-06-03,38,40,13,14,15,4,33,91
2021-06-04,50,36,12,22,14,3,39,98
2021-06-05,73,49,30,12,8,3,23,152
2021-06-06,77,51,29,14,10,2,26,157
2021-06-07,62,41,32,16,11,3,30,135
2021-06-08,61,40,26,18,13,2,33,127
2021-06-09,55,44,24,18,14,6,38,123
2021-06-10,63,42,21,15,11,4,30,126
2021-06-11,70,44,30,15,10,4,29,144
2021-06-12,74,54,35,11,9,3,23,163
2021-06-13,69,51,27,10,8,2,20,147
2021-06-14,56,42,21,17,13,3,33,119
2021-06-15,61,41,28,16,11,3,30,130
2021-06-16,61,38,27,15,11,4,30,126
2021-06-17,64,39,33,14,10,5,29,136
2021-06-18,64,45,34,15,12,5,32,143
2021-06-19,78,49,38,11,7,4,22,165
2021-06-20,70,50,30,10,7,3,20,150
2021-06-21,60,38,21,22,14,4,40,119
2021-06-22,40,39,29,11,12,3,26,108
2021-06-23,45,42,28,9,11,4,24,115
2021-06-24,75,41,32,15,9,4,28,148
2021-06-25,82,40,34,13,7,4,24,156
2021-06-26,106,57,33,10,7,3,20,196
2021-06-27,86,62,34,11,11,2,24,182
2021-06-28,67,46,31,10,9,2,21,144
2021-06-29,70,41,34,10,9,3,22,145
2021-06-30,73,48,31,17,17,6,40,152
2021-07-01,88,53,38,14,13,7,34,179
2021-07-02,89,58,38,11,9,4,24,185
2021-07-03,138,80,36,9,8,3,20,254
2021-07-04,88,65,26,10,11,2,23,179
2021-07-05,72,51,25,9,9,3,21,148
2021-07-06,88,48,28,14,10,4,28,164
2021-07-07,75,45,34,12,11,5,28,154
2021-07-08,85,44,39,13,9,5,27,168
2021-07-09,109,77,35,12,10,3,25,221
2021-07-10,116,73,32,13,8,3,24,221
2021-07-11,85,61,24,9,10,3,22,170
2021-07-12,68,47,16,12,10,2,24,131
2021-07-13,88,47,33,14,9,4,27,168
2021-07-14,82,52,36,15,13,5,33,170
2021-07-15,78,58,42,11,14,6,31,178
2021-07-16,121,72,42,14,11,5,30,235
2021-07-17,117,89,46,9,10,3,22,252
2021-07-18,117,61,29,12,8,3,23,207
2021-07-19,81,51,24,10,9,3,22,156
2021-07-20,97,40,37,14,7,3,24,174
2021-07-21,73,57,35,9,10,4,23,165
2021-07-22,86,44,37,9,7,5,21,167
2021-07-23,93,75,41,10,11,4,25,209
2021-07-24,80,74,40,8,11,4,23,194
2021-07-25,91,57,27,7,8,3,18,175
2021-07-26,95,49,22,10,8,2,20,166
2021-07-27,87,47,32,10,10,5,25,166
2021-07-28,98,54,37,11,9,5,25,189
2021-07-29,110,50,40,11,8,5,24,200
2021-07-30,95,70,41,8,10,5,23,206
2021-07-31,102,77,40,6,9,4,19,219
2021-08-01,78,48,29,7,7,3,17,155
2021-08-02,81,56,24,10,10,3,23,161
2021-08-03,98,56,31,10,9,4,23,185
2021-08-04,80,54,32,6,9,4,19,166
2021-08-05,92,55,41,8,8,5,21,188
2021-08-06,128,56,34,9,8,4,21,218
2021-08-07,96,75,29,7,11,3,21,200
2021-08-08,92,67,30,6,10,3,19,189
2021-08-09,113,53,25,10,9,3,22,191
2021-08-10,67,50,31,8,9,4,21,148
2021-08-11,70,53,24,8,8,3,19,147
2021-08-12,100,58,40,10,9,4,23,198
2021-08-13,137,55,42,11,8,4,23,234
2021-08-14,139,66,33,6,7,3,16,238
2021-08-15,80,67,24,7,8,2,17,171
2021-08-16,107,47,24,13,8,3,24,178
2021-08-17,73,49,38,9,10,6,25,160
2021-08-18,58,47,37,8,8,5,21,142
2021-08-19,95,46,41,11,8,6,25,182
2021-08-20,103,71,34,9,10,4,23,208
2021-08-21,158,63,40,7,7,3,17,261
2021-08-22,101,58,29,8,8,3,19,188
2021-08-23,82,67,26,6,10,2,18,175
2021-08-24,69,57,37,9,12,6,27,163
2021-08-25,94,58,37,11,9,4,24,189
2021-08-26,93,57,41,9,9,5,23,191
2021-08-27,106,69,40,10,9,4,23,215
2021-08-28,122,69,31,8,7,3,18,222
2021-08-29,96,57,31,7,9,4,20,184
2021-08-30,106,53,22,14,8,3,25,181
2021-08-31,85,54,36,13,10,5,28,175
2021-09-01,104,54,38,11,9,5,25,196
2021-09-02,100,56,37,14,9,5,28,193
2021-09-03,115,69,35,11,8,3,22,219
2021-09-04,128,65,32,8,6,2,16,225
2021-09-05,116,61,43,6,7,4,17,220
2021-09-06,84,61,28,11,11,3,25,173
2021-09-07,95,50,37,10,8,4,22,182
2021-09-08,79,53,38,13,10,4,27,170
2021-09-09,90,55,42,10,10,6,26,187
2021-09-10,101,72,34,11,10,4,25,207
2021-09-11,122,69,29,12,9,3,24,220
2021-09-12,108,78,33,8,12,4,24,219
2021-09-13,90,54,22,11,11,3,25,166
2021-09-14,97,51,36,14,10,5,29,184
2021-09-15,97,49,36,16,11,6,33,182
2021-09-16,80,51,38,12,10,5,27,169
2021-09-17,96,59,40,10,8,4,22,195
2021-09-18,121,80,40,8,8,3,19,241
2021-09-19,111,69,29,10,9,2,21,209
2021-09-20,82,64,21,8,8,2,18,167
2021-09-21,115,57,25,13,8,3,24,197
2021-09-22,101,56,39,11,9,4,24,196
2021-09-23,83,57,41,10,11,6,27,181
2021-09-24,133,61,42,11,8,4,23,236
2021-09-25,144,59,47,9,6,3,18,250
2021-09-26,132,77,34,8,8,3,19,243
2021-09-27,103,72,31,12,10,3,25,206
2021-09-28,105,57,32,11,8,3,22,194
2021-09-29,112,43,35,16,7,4,27,190
2021-09-30,84,58,38,17,14,7,38,180
2021-10-01,106,77,39,188,203,80,471,222
2021-10-02,120,90,41,8,10,3,21,251
2021-10-03,111,72,43,8,9,3,20,226
2021-10-04,94,59,30,13,10,3,26,183
2021-10-05,91,52,37,16,10,6,32,180
2021-10-06,92,61,29,13,10,4,27,182
2021-10-07,100,56,39,13,9,4,26,195
2021-10-08,109,72,43,10,9,4,23,224
2021-10-09,137,74,41,9,7,3,19,252
2021-10-10,128,71,34,10,9,3,22,233
2021-10-11,91,62,27,11,10,3,24,180
2021-10-12,95,52,37,16,10,5,31,184
2021-10-13,85,56,35,14,9,5,28,176
2021-10-14,92,65,33,10,8,3,21,190
2021-10-15,123,59,44,10,7,3,20,226
2021-10-16,139,77,45,9,8,3,20,261
2021-10-17,119,83,42,9,10,4,23,244
2021-10-18,87,64,26,10,10,3,23,177
2021-10-19,72,58,34,10,10,4,24,164
2021-10-20,81,56,37,11,11,5,27,174
2021-10-21,112,66,32,13,12,4,29,210
2021-10-22,131,69,29,13,9,3,25,229
2021-10-23,91,90,43,7,10,3,20,224
2021-10-24,74,77,36,6,8,3,17,187
2021-10-25,92,66,30,9,10,3,22,188
2021-10-26,84,63,36,9,10,4,23,183
2021-10-27,105,70,38,13,11,5,29,213
2021-10-28,95,72,29,11,12,4,27,196
2021-10-29,110,77,32,7,8,3,18,219
2021-10-30,148,80,37,9,7,2,18,265
2021-10-31,97,80,43,10,10,4,24,220
2021-11-01,99,82,33,9,11,3,23,214
2021-11-02,87,49,23,11,10,3,24,159
2021-11-03,101,67,38,11,10,3,24,206
2021-11-04,107,63,41,12,8,4,24,211
2021-11-05,122,62,32,11,8,2,21,216
2021-11-06,123,78,45,9,9,3,21,246
2021-11-07,94,74,44,7,11,5,23,212
2021-11-08,110,43,30,11,8,3,22,183
2021-11-09,92,57,22,9,10,3,22,171
2021-11-10,97,64,34,11,13,4,28,195
2021-11-11,110,72,42,9,8,3,20,224
2021-11-12,123,67,33,8,7,2,17,223
2021-11-13,110,69,35,9,10,4,23,214
2021-11-14,102,67,37,12,10,4,26,206
2021-11-15,98,52,24,12,9,3,24,174
2021-11-16,95,45,33,16,12,6,34,173
2021-11-17,75,49,33,13,11,6,30,157
2021-11-18,75,42,34,11,9,6,26,151
2021-11-19,92,58,30,12,10,4,26,180
2021-11-20,101,74,29,8,10,3,21,204
2021-11-21,100,58,34,10,10,4,24,192
2021-11-22,76,54,27,14,13,5,32,157
2021-11-23,68,46,32,13,12,6,31,146
2021-11-24,74,63,29,13,17,6,36,166
2021-11-25,112,53,33,19,13,6,38,198
2021-11-26,90,58,20,12,12,3,27,168
2021-11-27,106,78,27,11,11,3,25,211
2021-11-28,72,46,27,13,11,5,29,145
2021-11-29,49,37,24,16,14,7,37,110
2021-11-30,46,30,25,25,19,11,55,101
2021-12-01,55,40,23,18,16,7,41,118
2021-12-02,47,31,26,33,24,15,72,104
2021-12-03,58,39,24,25,18,8,51,121
2021-12-04,64,50,29,12,12,6,30,143
2021-12-05,65,46,27,15,13,6,34,138
2021-12-06,44,37,22,31,25,13,69,103
2021-12-07,45,35,24,16,14,7,37,104
2021-12-08,49,38,27,26,26,12,64,114
2021-12-09,56,32,28,36,20,14,70,116
2021-12-10,52,33,22,26,16,8,50,107
2021-12-11,76,51,28,14,10,4,28,155
2021-12-12,65,45,27,14,12,6,32,137
2021-12-13,48,34,21,24,19,10,53,103
2021-12-14,47,32,23,29,20,11,60,102
2021-12-15,46,33,24,34,23,13,70,103
2021-12-16,53,33,19,22,13,6,41,105
2021-12-17,50,40,22,18,14,6,38,112
2021-12-18,96,52,26,14,10,4,28,174
2021-12-19,41,4,16,0,0,0,0,61
2021-12-20,0,17,0,0,0,0,0,17
2021-12-21,0,0,0,0,0,0,0,0
2021-12-22,0,0,0,0,0,0,0,0
2021-12-23,0,0,0,0,0,0,0,0
2021-12-24,0,0,0,0,0,0,0,0
2021-12-25,0,0,0,0,0,0,0,0
2021-12-26,0,0,0,0,0,0,0,0
2021-12-27,0,0,0,0,0,0,0,0
2021-12-28,0,0,0,0,0,0,0,0
2021-12-29,0,0,0,0,0,0,0,0
2021-12-30,0,0,0,0,0,0,0,0
2021-12-31,0,0,0,0,0,0,0,0
2022-01-01,0,0,0,0,0,0,0,0
2022-01-02,0,0,0,0,0,0,0,0
2022-01-03,0,0,0,0,0,0,0,0
2022-01-04,0,0,0,0,0,0,0,0
2022-01-05,0,0,0,0,0,0,0,0
2022-01-06,0,0,0,0,0,0,0,0
2022-01-07,0,0,0,0,0,0,0,0
2022-01-08,0,0,0,0,0,0,0,0
2022-01-09,0,0,0,0,0,0,0,0
2022-01-10,7,0,0,0,0,0,0,7
2022-01-11,0,0,0,0,0,0,0,0
2022-01-12,0,0,0,0,0,0,0,0
2022-01-13,0,0,0,0,0,0,0,0
2022-01-14,0,12,11,0,0,0,0,23
2022-01-15,0,0,0,0,0,0,0,0
2022-01-16,0,0,0,0,0,0,0,0
2022-01-17,0,0,0,0,0,0,0,0
2022-01-18,0,0,0,0,0,0,0,0
2022-01-19,0,0,0,0,0,0,0,0
2022-01-20,4,0,0,0,0,0,0,4
2022-01-21,0,0,0,0,0,0,0,0
2022-01-22,0,0,0,0,0,0,0,0
2022-01-23,0,0,0,0,0,0,0,0
2022-01-24,0,10,0,0,0,0,0,10
2022-01-25,8,29,4,0,0,0,0,41
2022-01-26,101,60,37,22,12,6,40,198
2022-01-27,107,54,36,26,14,7,47,197
2022-01-28,98,57,39,13,9,5,27,194
2022-01-29,127,65,43,13,7,4,24,235
2022-01-30,127,59,41,15,9,4,28,227
2022-01-31,67,39,34,29,21,10,60,140
2022-02-01,59,54,34,12,13,5,30,147
2022-02-02,79,48,37,23,14,9,46,164
2022-02-03,74,43,39,19,10,8,37,156
2022-02-04,87,48,39,14,10,5,29,174
2022-02-05,129,66,35,14,8,3,25,230
2022-02-06,79,52,37,18,14,8,40,168
2022-02-07,72,56,34,23,18,6,47,162
2022-02-08,68,62,33,14,15,5,34,163
2022-02-09,73,58,33,27,21,8,56,164
2022-02-10,83,55,39,24,17,9,50,177
2022-02-11,90,69,37,12,11,5,28,196
2022-02-12,127,73,34,10,7,3,20,234
2022-02-13,96,59,37,12,8,4,24,192
2022-02-14,93,65,39,11,8,3,22,197
2022-02-15,68,53,30,14,13,4,31,151
2022-02-16,64,60,32,17,18,7,42,156
2022-02-17,77,47,38,14,10,6,30,162
2022-02-18,67,58,36,20,19,9,48,161
2022-02-19,121,83,44,11,9,3,23,248
2022-02-20,85,68,38,14,13,6,33,191
2022-02-21,61,54,29,18,16,6,40,144
2022-02-22,76,49,32,18,13,5,36,157
2022-02-23,71,59,38,12,12,6,30,168
2022-02-24,76,58,43,16,12,7,35,177
2022-02-25,97,65,38,14,10,4,28,200
2022-02-26,125,85,44,10,8,3,21,254
2022-02-27,100,83,39,11,10,4,25,222
2022-02-28,85,59,37,12,10,3,25,181
2022-03-01,82,69,39,11,11,4,26,190
2022-03-02,79,69,36,15,14,4,33,184
2022-03-03,78,57,38,13,10,5,28,173
2022-03-04,110,76,36,15,11,4,30,222
2022-03-05,122,98,35,11,9,3,23,255
2022-03-06,122,90,40,10,10,4,24,252
2022-03-07,79,68,34,15,14,6,35,181
2022-03-08,76,64,33,11,10,4,25,173
2022-03-09,84,68,34,15,12,5,32,186
2022-03-10,78,69,40,12,11,5,28,187
2022-03-11,94,71,39,11,10,4,25,204
2022-03-12,122,92,34,10,9,3,22,248
2022-03-13,108,78,40,11,10,4,25,226
2022-03-14,83,72,35,14,13,3,30,190
2022-03-15,77,64,38,13,12,5,30,179
2022-03-16,74,70,39,12,13,5,30,183
2022-03-17,90,63,32,13,10,4,27,185
2022-03-18,100,73,30,12,10,3,25,203
2022-03-19,130,84,50,10,9,3,22,264
2022-03-20,104,80,32,11,9,3,23,216
2022-03-21,88,64,32,12,9,4,25,184
2022-03-22,82,66,39,10,10,4,24,187
2022-03-23,105,70,35,15,11,3,29,210
2022-03-24,105,70,30,12,11,3,26,205
2022-03-25,122,81,33,11,9,3,23,236
2022-03-26,134,92,43,9,7,3,19,269
2022-03-27,122,86,43,11,9,4,24,251
2022-03-28,104,78,33,13,10,3,26,215
2022-03-29,97,65,41,10,8,3,21,203
2022-03-30,104,68,37,10,8,3,21,209
2022-03-31,101,68,40,14,10,5,29,209
2022-04-01,106,65,40,10,8,4,22,211
2022-04-02,133,85,46,7,7,3,17,264
2022-04-03,120,67,55,10,7,3,20,242
2022-04-04,99,74,31,11,9,2,22,204
2022-04-05,92,70,39,11,10,4,25,201
2022-04-06,100,67,37,9,9,3,21,204
2022-04-07,100,82,38,9,10,3,22,220
2022-04-08,115,89,43,11,10,3,24,247
2022-04-09,142,100,43,8,8,3,19,285
2022-04-10,126,80,44,7,7,3,17,250
2022-04-11,119,70,32,9,7,3,19,221
2022-04-12,114,68,40,9,7,3,19,222
2022-04-13,117,75,36,9,7,3,19,228
2022-04-14,113,78,40,10,8,3,21,231
2022-04-15,141,85,44,9,7,3,19,270
2022-04-16,141,95,36,6,8,2,16,272
2022-04-17,135,79,57,11,9,4,24,271
2022-04-18,147,79,53,12,9,4,25,279
2022-04-19,109,81,41,7,7,2,16,231
2022-04-20,121,84,36,9,8,3,20,241
2022-04-21,116,84,43,9,9,3,21,243
2022-04-22,125,93,44,8,9,2,19,262
2022-04-23,141,94,42,7,8,2,17,277
2022-04-24,130,100,46,7,9,3,19,276
2022-04-25,121,72,37,8,7,3,18,230
2022-04-26,128,74,39,8,8,4,20,241
2022-04-27,115,83,42,13,14,3,30,240
2022-04-28,100,67,48,7,8,3,18,215
2022-04-29,116,93,53,7,9,2,18,262
2022-04-30,159,96,61,6,7,3,16,316
2022-05-01,126,79,68,6,7,3,16,273
2022-05-02,110,69,38,7,7,2,16,217
2022-05-03,110,73,45,6,7,2,15,228
2022-05-04,128,82,53,7,8,2,17,263
2022-05-05,127,74,46,8,7,2,17,247
2022-05-06,140,87,56,6,8,2,16,283
2022-05-07,164,98,41,5,8,2,15,303
2022-05-08,117,67,44,7,8,3,18,228
2022-05-09,127,81,37,9,9,2,20,245
2022-05-10,109,68,43,8,8,2,18,220
2022-05-11,121,68,32,6,9,3,18,221
2022-05-12,116,78,48,9,9,2,20,242
2022-05-13,114,75,46,7,7,2,16,235
2022-05-14,140,91,40,6,8,2,16,271
2022-05-15,123,82,46,7,9,2,18,251
2022-05-16,103,80,35,7,8,2,17,218
2022-05-17,118,79,40,10,9,2,21,237
2022-05-18,106,81,35,10,10,1,21,222
2022-05-19,109,72,50,8,9,2,19,231
2022-05-20,106,83,50,9,9,2,20,239
2022-05-21,139,85,40,8,7,2,17,264
2022-05-22,140,73,56,5,6,3,14,269
2022-05-23,126,78,44,10,9,2,21,248
2022-05-24,118,75,45,9,10,4,23,238
2022-05-25,111,89,45,9,13,4,26,245
2022-05-26,134,83,43,11,13,3,27,260
2022-05-27,158,91,60,8,8,3,19,309
2022-05-28,134,89,51,7,7,2,16,274
2022-05-29,143,71,56,6,7,3,16,270
2022-05-30,134,81,41,7,10,2,19,256
2022-05-31,123,68,40,7,8,3,18,231
2022-06-01,125,80,36,10,11,2,23,241
2022-06-02,125,73,39,9,8,2,19,237
2022-06-03,138,84,49,7,8,2,17,271
2022-06-04,141,90,54,6,7,3,16,285
2022-06-05,148,76,55,12,9,4,25,279
2022-06-06,133,86,51,13,11,3,27,270
2022-06-07,120,81,46,10,9,3,22,247
2022-06-08,136,89,37,9,10,2,21,262
2022-06-09,120,80,32,10,11,2,23,232
2022-06-10,149,87,41,11,9,2,22,277
2022-06-11,136,95,41,7,8,2,17,272
2022-06-12,128,77,57,7,7,3,17,262
2022-06-13,130,82,39,8,7,2,17,251
2022-06-14,129,76,50,9,8,2,19,255
2022-06-15,139,89,36,10,9,2,21,264
2022-06-16,133,87,38,11,9,2,22,258
2022-06-17,134,78,40,9,7,2,18,252
2022-06-18,153,88,49,7,7,2,16,290
2022-06-19,136,76,57,7,8,3,18,269
2022-06-20,126,79,47,9,8,2,19,252
2022-06-21,136,73,38,9,8,2,19,247
2022-06-22,132,80,44,10,8,2,20,256
2022-06-23,148,83,44,10,9,2,21,275
2022-06-24,146,84,49,9,9,3,21,279
2022-06-25,152,85,53,7,8,3,18,290
2022-06-26,157,72,58,7,6,3,16,287
2022-06-27,125,82,44,10,9,2,21,251
2022-06-28,124,74,38,7,7,2,16,236
2022-06-29,127,83,51,6,8,3,17,261
2022-06-30,120,86,42,8,10,2,20,248
2022-07-01,136,80,48,9,8,2,19,264
2022-07-02,160,92,50,7,7,2,16,302
2022-07-03,156,102,46,7,8,2,17,304
2022-07-04,129,76,38,8,7,2,17,243
2022-07-05,133,84,47,9,8,2,19,264
2022-07-06,127,76,41,11,9,3,23,244
2022-07-07,130,85,51,9,9,3,21,266
2022-07-08,151,82,49,10,8,2,20,282
2022-07-09,158,94,59,9,8,2,19,311
2022-07-10,129,79,43,9,8,3,20,251
2022-07-11,133,79,45,10,7,2,19,257
2022-07-12,125,81,47,11,9,3,23,253
2022-07-13,143,82,42,10,9,3,22,267
2022-07-14,132,87,49,10,10,3,23,268
2022-07-15,143,79,52,11,8,2,21,274
2022-07-16,170,85,49,11,7,2,20,304
2022-07-17,151,85,47,9,7,2,18,283
2022-07-18,124,79,46,10,8,2,20,249
2022-07-19,129,79,54,11,8,3,22,262
2022-07-20,132,81,41,10,9,3,22,254
2022-07-21,125,89,50,10,11,3,24,264
2022-07-22,142,88,49,9,8,2,19,279
2022-07-23,152,94,54,8,8,2,18,300
2022-07-24,153,87,43,9,8,2,19,283
2022-07-25,142,84,39,9,8,2,19,265
2022-07-26,122,79,47,9,9,3,21,248
2022-07-27,132,87,50,7,8,2,17,269
2022-07-28,133,91,42,9,10,3,22,266
2022-07-29,142,94,51,10,9,3,22,287
2022-07-30,156,100,46,9,8,2,19,302
2022-07-31,131,86,44,9,9,3,21,261
2022-08-01,143,76,38,10,6,2,18,257
2022-08-02,146,78,50,11,8,3,22,274
2022-08-03,144,89,54,10,10,3,23,287
2022-08-04,149,86,49,11,9,3,23,284
2022-08-05,157,79,42,10,8,2,20,278
2022-08-06,151,82,53,7,7,3,17,286
2022-08-07,147,82,34,8,7,2,17,263
2022-08-08,127,81,50,9,8,2,19,258
2022-08-09,130,92,52,8,9,3,20,274
2022-08-10,121,93,30,8,9,2,19,244
2022-08-11,161,88,52,9,8,3,20,301
2022-08-12,154,78,49,8,6,3,17,281
2022-08-13,143,76,63,7,8,2,17,282
2022-08-14,126,80,57,5,8,3,16,263
2022-08-15,110,77,51,8,9,2,19,238
2022-08-16,152,90,54,8,8,2,18,296
2022-08-17,141,78,51,10,9,3,22,270
2022-08-18,160,76,56,9,7,3,19,292
2022-08-19,157,91,60,8,7,2,17,308
2022-08-20,158,105,53,7,9,2,18,316
2022-08-21,152,75,58,7,7,2,16,285
2022-08-22,132,82,51,9,8,2,19,265
2022-08-23,149,87,54,9,9,3,21,290
2022-08-24,138,72,41,7,8,2,17,251
2022-08-25,136,81,48,6,10,3,19,265
2022-08-26,162,100,52,8,10,2,20,314
2022-08-27,155,100,58,8,9,2,19,313
2022-08-28,144,80,59,6,7,3,16,283
2022-08-29,130,80,43,7,9,2,18,253
2022-08-30,145,90,50,10,10,3,23,285
2022-08-31,152,86,53,11,11,3,25,291
2022-09-01,150,92,54,9,8,3,20,296
2022-09-02,159,94,51,8,8,2,18,304
2022-09-03,138,102,60,5,8,2,15,300
2022-09-04,144,82,62,6,6,2,14,288
2022-09-05,136,84,45,8,8,2,18,265
2022-09-06,136,83,53,9,8,3,20,272
2022-09-07,132,88,42,7,8,2,17,262
2022-09-08,142,81,43,10,8,2,20,266
2022-09-09,148,95,44,9,9,2,20,287
2022-09-10,166,95,58,9,8,2,19,319
2022-09-11,155,98,50,8,7,1,16,303
2022-09-12,148,93,44,11,8,2,21,285
2022-09-13,146,87,46,11,10,3,24,279
2022-09-14,147,80,44,14,8,3,25,271
2022-09-15,136,91,53,10,10,2,22,280
2022-09-16,151,98,53,13,11,3,27,302
2022-09-17,172,97,58,8,8,1,17,327
2022-09-18,157,86,50,8,7,3,18,293
2022-09-19,126,74,37,13,8,2,23,237
2022-09-20,136,75,48,14,9,4,27,259
2022-09-21,125,79,42,10,10,3,23,246
2022-09-22,131,74,47,9,9,3,21,252
2022-09-23,138,91,46,10,9,1,20,275
2022-09-24,167,79,51,10,7,2,19,297
2022-09-25,145,90,48,7,6,2,15,283
2022-09-26,122,78,37,12,10,3,25,237
2022-09-27,112,70,46,10,8,4,22,228
2022-09-28,127,68,37,13,8,3,24,232
2022-09-29,123,76,42,11,8,4,23,241
2022-09-30,129,93,49,9,8,3,20,271
2022-10-01,147,87,56,9,8,3,20,290
2022-10-02,140,71,57,6,5,2,13,268
2022-10-03,115,67,41,8,5,2,15,223
2022-10-04,130,70,47,13,8,4,25,247
2022-10-05,132,81,33,13,10,3,26,246
2022-10-06,140,92,41,12,10,3,25,273
2022-10-07,134,88,49,11,8,3,22,271
2022-10-08,159,93,53,9,7,2,18,305
2022-10-09,138,81,56,6,6,2,14,275
2022-10-10,130,83,41,9,9,3,21,254
2022-10-11,108,79,47,10,9,3,22,234
2022-10-12,132,79,44,11,9,3,23,255
2022-10-13,113,86,38,10,9,2,21,237
2022-10-14,148,89,45,9,8,2,19,282
2022-10-15,161,89,47,6,7,2,15,297
2022-10-16,151,77,57,7,6,3,16,285
2022-10-17,125,79,32,9,9,2,20,236
2022-10-18,125,85,40,8,8,2,18,250
2022-10-19,123,74,33,10,7,2,19,230
2022-10-20,125,97,28,8,10,1,19,250
2022-10-21,151,100,47,8,8,1,17,298
2022-10-22,152,96,42,6,7,2,15,290
2022-10-23,123,70,54,5,6,2,13,247
2022-10-24,120,77,32,7,7,2,16,229
2022-10-25,115,78,46,9,8,3,20,239
2022-10-26,132,76,42,10,8,2,20,250
2022-10-27,123,76,38,9,7,2,18,237
2022-10-28,148,78,52,10,6,2,18,278
2022-10-29,151,93,50,5,7,2,14,294
2022-10-30,165,83,45,6,6,1,13,293
2022-10-31,114,86,37,6,7,2,15,237
2022-11-01,131,87,47,9,8,4,21,265
2022-11-02,124,75,45,10,9,3,22,244
2022-11-03,128,73,40,13,9,4,26,241
2022-11-04,132,78,46,9,8,3,20,256
2022-11-05,158,91,49,7,7,2,16,298
2022-11-06,124,87,45,8,9,3,20,256
2022-11-07,106,71,30,12,11,3,26,207
2022-11-08,112,71,44,13,9,4,26,227
2022-11-09,127,76,37,15,10,4,29,240
2022-11-10,120,73,38,11,9,4,24,231
2022-11-11,138,76,42,9,6,3,18,256
2022-11-12,190,101,55,8,7,2,17,346
2022-11-13,145,86,44,6,7,2,15,275
2022-11-14,128,83,43,11,10,3,24,254
2022-11-15,135,82,45,12,9,4,25,262
2022-11-16,157,76,39,12,8,3,23,272
2022-11-17,134,92,42,12,12,4,28,268
2022-11-18,157,86,44,12,8,3,23,287
2022-11-19,179,100,44,7,7,3,17,323
2022-11-20,153,91,53,7,8,2,17,297
2022-11-21,140,74,34,13,9,3,25,248
2022-11-22,130,83,46,13,11,4,28,259
2022-11-23,127,80,44,12,11,4,27,251
2022-11-24,140,91,40,14,10,4,28,271
2022-11-25,150,84,46,11,8,3,22,280
2022-11-26,155,94,50,6,7,2,15,299
2022-11-27,132,82,52,9,8,3,20,266
2022-11-28,114,71,31,11,11,3,25,216
2022-11-29,114,71,44,13,12,5,30,229
2022-11-30,129,83,35,13,11,3,27,247
2022-12-01,125,83,38,11,10,3,24,246
2022-12-02,147,91,48,10,8,3,21,286
2022-12-03,147,86,51,8,7,3,18,284
2022-12-04,126,89,53,6,8,3,17,268
2022-12-05,107,76,30,10,10,3,23,213
2022-12-06,121,83,47,14,13,4,31,251
2022-12-07,114,77,36,11,12,4,27,227
2022-12-08,129,68,51,12,8,4,24,248
2022-12-09,126,90,53,10,10,3,23,269
2022-12-10,152,94,57,7,7,3,17,303
2022-12-11,132,94,53,6,9,3,18,279
2022-12-12,110,81,30,10,9,2,21,221
2022-12-13,103,79,24,16,17,4,37,206
2022-12-14,101,73,44,8,10,3,21,218
2022-12-15,95,84,29,7,9,2,18,208
2022-12-16,127,78,53,9,8,3,20,258
2022-12-17,175,89,49,7,7,3,17,313
2022-12-18,99,89,55,7,12,3,22,243
2022-12-19,104,79,30,7,9,2,18,213
2022-12-20,100,79,48,10,11,3,24,227
2022-12-21,119,90,28,8,11,2,21,237
2022-12-22,124,84,37,9,9,2,20,245
2022-12-23,163,84,52,12,9,2,23,299
2022-12-24,60,56,25,11,14,5,30,141
2022-12-25,145,77,17,7,8,2,17,239
2022-12-26,146,85,53,10,9,2,21,284
2022-12-27,139,84,55,7,7,2,16,278
2022-12-28,119,93,47,5,7,2,14,259
2022-12-29,166,87,57,6,7,2,15,310
2022-12-30,159,87,54,7,6,2,15,300
2022-12-31,130,94,51,7,8,2,17,275
2023-01-01,154,80,54,9,8,2,19,288
2023-01-02,135,69,41,12,7,2,21,245
2023-01-03,109,68,53,7,6,3,16,230
2023-01-04,108,70,49,8,7,3,18,227
2023-01-05,150,79,48,7,8,2,17,277
2023-01-06,126,73,61,6,7,2,15,260
2023-01-07,173,93,42,11,7,2,20,308
2023-01-08,101,89,44,6,13,4,23,234
2023-01-09,118,74,29,11,11,4,26,221
2023-01-10,78,71,48,10,13,7,30,197
2023-01-11,104,85,47,10,13,4,27,236
2023-01-12,106,80,43,10,14,5,29,229
2023-01-13,131,78,51,9,8,3,20,260
2023-01-14,162,92,58,9,9,3,21,312
2023-01-15,93,80,41,6,12,3,21,214
2023-01-16,75,67,28,12,14,5,31,170
2023-01-17,98,80,52,12,15,6,33,230
2023-01-18,69,67,34,9,11,5,25,170
2023-01-19,89,76,38,10,11,4,25,203
2023-01-20,113,75,42,8,8,4,20,230
2023-01-21,136,96,56,7,8,3,18,288
2023-01-22,114,83,44,10,9,3,22,241
2023-01-23,77,78,38,9,12,5,26,193
2023-01-24,102,59,46,11,10,7,28,207
2023-01-25,101,67,52,5,9,6,20,220
2023-01-26,101,87,39,7,9,4,20,227
2023-01-27,134,76,45,5,6,3,14,255
2023-01-28,145,101,40,5,7,2,14,286
2023-01-29,99,90,49,6,11,3,20,238
2023-01-30,87,71,39,10,12,5,27,197
2023-01-31,89,69,49,9,11,7,27,207
2023-02-01,111,76,37,10,10,4,24,224
2023-02-02,105,76,47,7,11,6,24,228
2023-02-03,132,96,51,6,8,4,18,279
2023-02-04,128,97,55,5,8,2,15,280
2023-02-05,110,83,43,7,8,3,18,236
2023-02-06,102,76,42,8,10,5,23,220
2023-02-07,83,83,49,11,11,7,29,215
2023-02-08,80,64,37,10,11,6,27,181
2023-02-09,96,74,53,5,7,4,16,223
2023-02-10,140,83,41,5,7,3,15,264
2023-02-11,164,86,57,6,6,2,14,307
2023-02-12,78,82,51,4,10,3,17,211
2023-02-13,104,66,41,10,8,5,23,211
2023-02-14,165,85,62,6,7,4,17,312
2023-02-15,93,82,43,8,11,5,24,218
2023-02-16,128,86,50,7,9,5,21,264
2023-02-17,153,85,44,9,7,3,19,282
2023-02-18,133,100,34,7,7,2,16,267
2023-02-19,104,81,45,7,8,3,18,230
2023-02-20,88,71,40,5,7,4,16,199
2023-02-21,103,79,48,8,8,5,21,230
2023-02-22,104,84,44,8,9,5,22,232
2023-02-23,122,101,50,5,12,5,22,273
2023-02-24,162,87,49,8,7,4,19,298
2023-02-25,175,100,56,5,6,2,13,331
2023-02-26,131,85,44,8,8,2,18,260
2023-02-27,109,81,39,8,8,4,20,229
2023-02-28,93,76,50,7,8,6,21,219
2023-03-01,113,96,47,9,11,5,25,256
2023-03-02,132,92,35,7,10,3,20,259
2023-03-03,158,101,52,8,8,3,19,311
2023-03-04,167,88,58,7,6,3,16,313
2023-03-05,130,78,43,7,6,2,15,251
2023-03-06,114,78,39,12,10,5,27,231
2023-03-07,111,79,43,14,10,5,29,233
2023-03-08,94,89,44,8,11,4,23,227
2023-03-09,170,86,43,10,10,3,23,299
2023-03-10,157,92,42,8,8,2,18,291
2023-03-11,173,104,40,6,7,2,15,317
2023-03-12,113,90,42,5,7,2,14,245
2023-03-13,0,0,0,0,0,0,0,0
2023-03-14,69,67,37,14,14,7,35,173
2023-03-15,107,90,27,9,8,3,20,224
2023-03-16,129,95,36,8,8,3,19,260
2023-03-17,176,99,47,7,7,2,16,322
2023-03-18,181,97,43,5,5,2,12,321
2023-03-19,142,74,51,6,5,2,13,267
2023-03-20,110,68,42,8,6,4,18,220
2023-03-21,92,75,50,5,8,4,17,217
2023-03-22,116,71,46,2,6,3,11,233
2023-03-23,132,82,46,8,7,3,18,260
2023-03-24,156,80,50,8,5,2,15,286
2023-03-25,170,96,41,5,5,1,11,307
2023-03-26,126,73,48,5,4,1,10,247
2023-03-27,127,73,45,7,5,3,15,245
2023-03-28,92,78,48,5,7,4,16,218
2023-03-29,102,74,52,6,7,3,16,228
2023-03-30,119,78,37,5,6,2,13,234
2023-03-31,151,84,53,6,5,1,12,288
2023-04-01,173,89,53,5,5,2,12,315
2023-04-02,137,88,49,6,6,2,14,274
2023-04-03,134,78,45,9,8,4,21,257
2023-04-04,94,84,48,6,7,4,17,226
2023-04-05,138,83,47,6,7,3,16,268
2023-04-06,146,89,43,6,6,3,15,278
2023-04-07,201,85,49,7,5,2,14,335
2023-04-08,191,85,41,6,4,2,12,317
2023-04-09,198,78,64,12,8,2,22,340
2023-04-10,154,79,68,11,8,4,23,301
2023-04-11,81,71,53,7,6,4,17,205
2023-04-12,115,77,52,7,7,4,18,244
2023-04-13,142,76,51,8,5,3,16,269
2023-04-14,130,73,51,8,5,2,15,254
2023-04-15,169,99,47,6,6,2,14,315
2023-04-16,134,73,57,7,5,3,15,264
2023-04-17,113,85,48,7,7,4,18,246
2023-04-18,105,85,51,7,8,4,19,241
2023-04-19,114,88,52,6,8,4,18,254
2023-04-20,140,74,55,11,6,4,21,269
2023-04-21,115,89,61,5,5,3,13,265
2023-04-22,187,99,58,7,6,3,16,344
2023-04-23,163,91,58,0,0,0,0,312
2023-04-24,118,97,55,6,7,4,17,270
2023-04-25,116,81,64,6,7,5,18,261
2023-04-26,132,85,54,6,6,3,15,271
2023-04-27,112,67,59,7,6,5,18,238
2023-04-28,164,72,61,6,4,3,13,297
2023-04-29,190,90,55,7,5,2,14,335
2023-04-30,158,88,66,6,5,3,14,312
2023-05-01,136,88,54,5,5,4,14,278
2023-05-02,132,89,56,6,8,4,18,277
2023-05-03,175,105,44,6,9,3,18,324
2023-05-04,153,98,63,8,6,3,17,314
2023-05-05,168,81,59,7,5,3,15,308
2023-05-06,174,82,64,5,5,2,12,320
2023-05-07,129,84,62,4,6,3,13,275
2023-05-08,130,84,52,6,6,3,15,266
2023-05-09,106,98,55,5,9,4,18,259
2023-05-10,116,105,54,7,10,4,21,275
2023-05-11,146,93,61,9,7,4,20,300
2023-05-12,193,80,65,9,6,3,18,338
2023-05-13,187,80,57,6,5,2,13,324
2023-05-14,159,99,60,8,7,3,18,318
2023-05-15,114,85,53,7,7,4,18,252
2023-05-16,97,84,55,7,9,5,21,236
2023-05-17,123,101,55,5,8,3,16,279
2023-05-18,182,94,60,10,7,4,21,336
2023-05-19,153,94,64,6,5,3,14,311
2023-05-20,177,86,62,8,6,3,17,325
2023-05-21,132,85,62,7,5,3,15,279
2023-05-22,141,72,55,5,5,4,14,268
2023-05-23,111,79,56,5,8,5,18,246
2023-05-24,127,106,54,6,9,4,19,287
2023-05-25,146,97,60,7,7,5,19,303
2023-05-26,121,100,64,6,7,4,17,285
2023-05-27,171,103,64,6,6,3,15,338
2023-05-28,151,85,62,8,6,4,18,298
2023-05-29,140,91,63,7,7,5,19,294
2023-05-30,50,87,49,4,8,5,17,186
2023-05-31,97,88,52,6,9,5,20,237
2023-06-01,149,107,57,9,9,5,23,313
2023-06-02,175,89,67,8,7,4,19,331
2023-06-03,163,109,67,7,7,3,17,339
2023-06-04,150,80,74,6,5,3,14,304
2023-06-05,154,61,53,11,6,4,21,268
2023-06-06,149,91,56,11,8,4,23,296
2023-06-07,139,103,53,10,10,4,24,295
2023-06-08,163,85,60,9,7,5,21,308
2023-06-09,177,98,64,9,7,4,20,339
2023-06-10,149,104,69,8,7,3,18,322
2023-06-11,143,77,69,8,6,4,18,289
2023-06-12,141,73,53,9,6,5,20,267
2023-06-13,121,58,62,10,6,7,23,241
2023-06-14,144,92,53,13,7,4,24,289
2023-06-15,168,80,60,10,6,4,20,308
2023-06-16,170,110,69,7,7,4,18,349
2023-06-17,128,88,60,7,7,3,17,276
2023-06-18,145,72,74,6,4,4,14,291
2023-06-19,140,82,53,9,7,4,20,275
2023-06-20,125,76,57,15,9,6,30,258
2023-06-21,126,101,53,11,9,5,25,280
2023-06-22,153,102,62,11,9,5,25,317
2023-06-23,177,88,66,11,6,4,21,331
2023-06-24,167,87,54,9,6,3,18,308
2023-06-25,137,75,59,7,4,3,14,271
2023-06-26,151,88,35,13,8,3,24,274
2023-06-27,127,71,63,8,8,5,21,261
2023-06-28,129,101,54,11,10,5,26,284
2023-06-29,155,85,59,13,8,5,26,299
2023-06-30,186,102,64,9,8,4,21,352
2023-07-01,165,62,64,9,5,3,17,291
2023-07-02,166,62,65,13,6,4,23,293
2023-07-03,130,88,40,9,8,3,20,258
2023-07-04,124,77,55,10,8,4,22,256
2023-07-05,74,76,51,8,12,7,27,201
2023-07-06,183,94,58,13,9,4,26,335
2023-07-07,184,92,66,14,9,5,28,342
2023-07-08,144,88,58,11,11,4,26,290
2023-07-09,134,83,47,9,7,4,20,264
2023-07-10,126,94,55,9,8,4,21,275
2023-07-11,129,95,48,10,9,4,23,272
2023-07-12,114,106,54,10,10,4,24,274
2023-07-13,162,103,62,10,9,5,24,327
2023-07-14,165,98,68,9,8,4,21,331
2023-07-15,148,90,59,7,6,2,15,297
2023-07-16,152,98,46,8,6,2,16,296
2023-07-17,138,104,49,9,8,4,21,291
2023-07-18,110,83,63,7,7,4,18,256
2023-07-19,139,103,54,10,7,4,21,296
2023-07-20,176,101,61,13,9,5,27,338
2023-07-21,174,77,61,12,6,4,22,312
2023-07-22,160,99,36,11,8,2,21,295
2023-07-23,149,100,67,8,7,3,18,316
2023-07-24,116,99,39,9,9,3,21,254
2023-07-25,124,105,54,9,10,4,23,283
2023-07-26,129,99,46,10,7,3,20,274
2023-07-27,160,84,59,12,7,4,23,303
2023-07-28,161,101,67,11,8,4,23,329
2023-07-29,135,104,61,8,7,3,18,300
2023-07-30,128,99,69,9,8,3,20,296
2023-07-31,125,85,62,10,6,4,20,272
2023-08-01,115,90,62,8,9,105,122,267
2023-08-02,128,111,53,10,9,103,122,292
2023-08-03,154,103,70,10,8,95,113,327
2023-08-04,165,106,64,12,10,235,257,335
2023-08-05,134,98,64,10,8,199,217,296
2023-08-06,126,96,67,10,8,191,209,289
2023-08-07,169,121,51,13,8,94,115,341
2023-08-08,151,103,55,11,9,106,126,309
2023-08-09,153,98,51,13,9,108,130,302
2023-08-10,172,99,76,11,6,127,144,347
2023-08-11,141,85,70,9,6,184,199,296
2023-08-12,145,82,53,9,5,177,191,280
2023-08-13,146,70,78,10,4,177,191,294
2023-08-14,152,90,52,13,6,107,126,294
2023-08-15,148,89,45,11,8,102,121,282
2023-08-16,164,98,40,11,7,95,113,302
2023-08-17,129,94,58,10,10,109,129,281
2023-08-18,167,99,65,13,9,183,205,331
2023-08-19,124,97,56,10,8,256,274,277
2023-08-20,105,94,65,10,10,266,286,264
2023-08-21,129,70,67,14,5,116,135,266
2023-08-22,166,86,49,15,9,126,150,301
2023-08-23,163,96,47,14,8,125,147,306
2023-08-24,137,102,58,9,9,97,115,297
2023-08-25,137,76,59,9,6,180,195,272
2023-08-26,194,89,68,12,6,185,203,351
2023-08-27,114,73,56,7,4,184,195,243
2023-08-28,126,67,61,10,4,98,112,254
2023-08-29,154,87,54,12,9,103,124,295
2023-08-30,142,97,53,13,10,140,163,292
2023-08-31,122,97,56,11,10,123,144,275
2023-09-01,148,104,51,11,11,231,253,303
2023-09-02,200,98,59,13,8,217,238,357
2023-09-03,127,71,52,10,7,209,226,250
2023-09-04,125,64,54,12,6,132,150,243
2023-09-05,149,84,56,16,10,137,163,289
2023-09-06,126,74,51,15,11,144,170,251
2023-09-07,140,83,58,11,8,101,120,281
2023-09-08,171,96,66,11,8,210,229,333
2023-09-09,174,97,59,9,5,157,171,330
2023-09-10,138,89,61,9,6,189,204,288
2023-09-11,137,66,47,12,6,127,145,250
2023-09-12,134,82,48,13,9,122,144,264
2023-09-13,125,83,54,11,10,147,168,262
2023-09-14,154,91,121,12,10,227,249,366
2023-09-15,209,95,74,11,6,153,170,378
2023-09-16,179,108,46,9,6,140,155,333
2023-09-17,153,91,67,9,6,82,97,311
2023-09-18,127,77,52,10,8,5,23,256
2023-09-19,120,86,51,11,10,5,26,257
2023-09-20,124,81,46,10,8,142,160,251
2023-09-21,137,101,52,10,10,120,140,290
2023-09-22,182,84,68,13,7,97,117,334
2023-09-23,189,96,58,9,5,89,103,343
2023-09-24,148,82,55,9,6,84,99,285
2023-09-25,128,94,48,10,7,4,21,270
2023-09-26,120,92,52,10,9,5,24,264
2023-09-27,120,78,50,12,8,120,140,248
2023-09-28,167,83,57,13,7,132,152,307
2023-09-29,187,90,61,12,8,89,109,338
2023-09-30,203,114,60,9,7,84,100,377
2023-10-01,143,94,57,7,5,4,16,294
2023-10-02,138,91,56,9,6,4,19,285
2023-10-03,121,103,41,11,13,4,28,265
2023-10-04,118,93,48,9,9,4,22,259
2023-10-05,147,88,50,10,7,4,21,285
2023-10-06,171,79,59,12,6,4,22,309
2023-10-07,185,91,49,9,6,3,18,325
2023-10-08,144,84,70,9,5,6,20,298
2023-10-09,129,93,48,10,8,5,23,270
2023-10-10,132,82,55,12,9,6,27,269
2023-10-11,139,98,51,11,9,5,25,288
2023-10-12,146,95,50,10,8,5,23,291
2023-10-13,178,86,64,11,7,5,23,328
2023-10-14,202,119,54,10,7,3,20,375
2023-10-15,159,81,51,13,6,5,24,291
2023-10-16,125,97,25,12,9,2,23,247
2023-10-17,140,101,47,11,9,4,24,288
2023-10-18,138,82,46,12,10,4,26,266
2023-10-19,182,94,61,13,6,4,23,337
2023-10-20,170,102,63,9,6,3,18,335
2023-10-21,154,83,29,9,6,2,17,266
2023-10-22,155,62,42,8,3,3,14,259
2023-10-23,124,68,52,11,5,5,21,244
2023-10-24,139,83,50,11,8,4,23,272
2023-10-25,164,90,54,12,9,4,25,308
2023-10-26,161,76,51,14,6,4,24,288
2023-10-27,202,85,55,10,6,3,19,342
2023-10-28,187,96,35,8,6,2,16,318
2023-10-29,157,81,47,10,5,3,18,285
2023-10-30,131,65,63,11,5,7,23,259
2023-10-31,135,72,41,14,9,4,27,248
2023-11-01,185,91,53,15,7,4,26,329
2023-11-02,187,89,66,17,8,5,30,342
2023-11-03,161,80,63,14,7,4,25,304
2023-11-04,215,107,55,12,6,2,20,377
2023-11-05,185,102,61,12,6,4,22,348
2023-11-06,138,79,61,13,8,5,26,278
2023-11-07,135,76,63,14,9,7,30,274
2023-11-08,157,87,52,15,7,4,26,296
2023-11-09,152,111,51,15,9,4,28,314
2023-11-10,201,108,68,16,8,4,28,377
2023-11-11,184,89,60,9,5,3,17,333
2023-11-12,167,91,56,12,6,3,21,314
2023-11-13,142,71,56,16,6,5,27,269
2023-11-14,150,63,58,12,7,5,24,271
2023-11-15,188,99,58,13,8,5,26,345
2023-11-16,195,99,60,14,5,4,23,354
2023-11-17,218,109,64,13,7,3,23,391
2023-11-18,218,102,61,10,5,2,17,381
2023-11-19,173,90,64,8,4,3,15,327
2023-11-20,134,74,54,13,7,5,25,262
2023-11-21,137,85,62,17,12,7,36,284
2023-11-22,148,80,53,17,9,6,32,281
2023-11-23,160,87,58,13,7,5,25,305
2023-11-24,167,96,47,11,7,3,21,310
2023-11-25,229,83,41,13,5,2,20,353
2023-11-26,181,65,68,15,5,7,27,314
2023-11-27,110,82,50,16,15,8,39,242
2023-11-28,115,78,54,13,10,6,29,247
2023-11-29,122,86,54,16,10,6,32,262
2023-11-30,155,85,59,13,7,5,25,299
2023-12-01,192,91,64,13,6,4,23,347
2023-12-02,210,98,36,11,5,2,18,344
2023-12-03,152,84,64,13,8,6,27,300
2023-12-04,146,67,51,19,11,7,37,264
2023-12-05,127,73,53,20,12,7,39,253
2023-12-06,119,83,53,12,9,6,27,255
2023-12-07,155,70,70,16,7,7,30,295
2023-12-08,190,94,65,15,8,5,28,349
2023-12-09,215,91,58,12,6,3,21,364
2023-12-10,134,76,45,11,7,4,22,255
2023-12-11,106,63,44,17,11,6,34,213
2023-12-12,105,56,45,17,9,6,32,206
2023-12-13,135,75,36,24,270,6,300,246
2023-12-14,127,97,57,13,177,6,196,281
2023-12-15,166,98,61,12,121,4,137,325
2023-12-16,188,96,44,12,106,3,121,328
2023-12-17,128,80,52,12,160,5,177,260
2023-12-18,109,81,52,15,11,7,33,242
2023-12-19,115,74,44,17,11,7,35,233
2023-12-20,123,63,31,19,228,4,251,217
2023-12-21,128,78,46,14,222,7,243,252
2023-12-22,177,85,48,16,170,4,190,310
2023-12-23,168,89,45,14,166,4,184,302
2023-12-24,51,43,38,12,12,9,33,132
2023-12-25,157,85,66,12,129,6,147,308
2023-12-26,175,79,69,15,187,6,208,323
2023-12-27,201,87,51,14,161,4,179,339
2023-12-28,156,84,48,9,6,3,18,288
2023-12-29,170,102,47,8,5,2,15,319
2023-12-30,143,87,60,7,4,3,14,290
2023-12-31,194,93,26,10,101,1,112,313
2024-01-01,137,74,54,11,225,6,242,265
2024-01-02,130,67,47,11,6,5,22,244
2024-01-03,143,73,40,11,117,4,132,256
2024-01-04,148,71,47,12,178,5,195,266
2024-01-05,150,85,59,13,106,6,125,294
2024-01-06,165,88,64,13,117,6,136,317
2024-01-07,105,80,58,16,13,10,39,243
2024-01-08,88,50,47,21,331,11,363,185
2024-01-09,76,57,52,14,240,10,264,185
2024-01-10,92,61,54,19,375,10,404,207
2024-01-11,110,56,38,21,369,7,397,204
2024-01-12,140,62,61,15,142,7,164,263
2024-01-13,155,80,59,16,8,6,30,294
2024-01-14,99,55,47,16,8,7,31,201
2024-01-15,82,53,46,19,338,10,367,181
2024-01-16,68,44,47,17,349,10,376,159
2024-01-17,86,45,37,25,533,10,568,168
2024-01-18,109,47,39,17,7,6,30,195
2024-01-19,127,61,48,14,7,5,26,236
2024-01-20,156,75,44,10,5,3,18,275
2024-01-21,116,67,49,17,10,7,34,232
2024-01-22,72,52,46,24,522,14,560,170
2024-01-23,61,44,44,20,480,13,513,149
2024-01-24,88,47,36,18,210,6,234,171
2024-01-25,87,49,41,18,11,9,38,177
2024-01-26,140,61,49,13,7,5,25,250
2024-01-27,173,79,57,11,100,4,115,309
2024-01-28,121,54,50,15,7,6,28,225
2024-01-29,73,50,36,20,377,9,406,159
2024-01-30,72,44,40,21,492,13,526,156
2024-01-31,110,55,51,24,282,10,316,216
2024-02-01,125,56,44,18,229,6,253,225
2024-02-02,141,72,50,13,178,5,196,263
2024-02-03,176,84,63,13,7,5,25,323
2024-02-04,111,67,56,13,9,7,29,234
2024-02-05,75,63,40,10,225,6,241,178
2024-02-06,76,46,46,12,241,8,261,168
2024-02-07,109,54,70,15,188,9,212,233
2024-02-08,125,58,44,15,7,5,27,227
2024-02-09,144,80,52,14,8,5,27,276
2024-02-10,171,77,48,12,89,3,104,296
2024-02-11,118,67,52,12,104,5,121,237
2024-02-12,97,69,34,17,285,5,307,200
2024-02-13,99,52,45,13,196,6,215,196
2024-02-14,162,80,45,10,127,3,140,287
2024-02-15,105,53,48,14,7,6,27,206
2024-02-16,140,64,60,11,131,5,147,264
2024-02-17,158,86,78,10,129,6,145,322
2024-02-18,126,68,54,15,9,7,31,248
2024-02-19,108,61,59,19,261,9,289,228
2024-02-20,87,50,60,17,283,10,310,197
2024-02-21,105,53,57,15,203,7,225,215
2024-02-22,97,54,56,16,9,9,34,207
2024-02-23,158,71,65,12,128,5,145,294
2024-02-24,179,69,64,12,102,4,118,312
2024-02-25,113,65,50,11,8,6,25,228
2024-02-26,66,49,43,16,12,10,38,158
2024-02-27,91,52,47,16,207,7,230,190
2024-02-28,102,56,45,18,251,8,277,203
2024-02-29,135,59,63,17,10,9,36,257
2024-03-01,194,69,66,16,142,6,164,329
2024-03-02,202,84,74,11,77,5,93,360
2024-03-03,136,65,57,17,10,7,34,258
2024-03-04,89,63,52,13,204,7,224,204
2024-03-05,96,58,55,16,250,9,275,209
2024-03-06,135,49,46,15,7,5,27,230
2024-03-07,126,64,52,13,8,6,27,242
2024-03-08,178,83,71,12,109,5,126,332
2024-03-09,185,98,70,11,83,4,98,353
2024-03-10,124,73,61,14,186,8,208,258
2024-03-11,95,57,56,19,287,11,317,208
2024-03-12,86,57,56,15,246,9,270,199
2024-03-13,95,58,48,17,295,9,321,201
2024-03-14,155,69,53,15,166,6,187,277
2024-03-15,183,74,62,15,7,5,27,319
2024-03-16,187,81,60,12,6,4,22,328
2024-03-17,150,66,58,18,153,6,177,274
2024-03-18,85,70,58,15,267,10,292,213
2024-03-19,96,62,62,17,247,10,274,220
2024-03-20,106,56,48,12,190,6,208,210
2024-03-21,152,77,59,14,168,6,188,288
2024-03-22,173,75,67,12,6,5,23,315
2024-03-23,162,90,67,9,7,4,20,319
2024-03-24,123,79,58,11,157,5,173,260
2024-03-25,104,80,56,9,158,5,172,240
2024-03-26,114,76,54,14,194,6,214,244
2024-03-27,125,65,53,13,121,6,140,243
2024-03-28,153,75,57,11,138,5,154,285
2024-03-29,198,83,80,10,75,4,89,361
2024-03-30,167,99,78,8,6,4,18,344
2024-03-31,190,89,67,17,9,7,33,346
2024-04-01,154,86,72,18,10,8,36,312
2024-04-02,114,72,62,14,9,8,31,248
2024-04-03,124,64,52,15,9,6,30,240
2024-04-04,146,62,49,13,6,4,23,257
2024-04-05,179,88,62,12,7,4,23,329
2024-04-06,200,93,77,12,6,4,22,370
2024-04-07,132,80,60,10,7,5,22,272
2024-04-08,132,78,70,15,10,8,33,280
2024-04-09,99,70,64,11,8,7,26,233
2024-04-10,150,72,57,13,7,5,25,279
2024-04-11,184,82,52,14,7,4,25,318
2024-04-12,197,83,70,11,6,4,21,350
2024-04-13,231,98,83,11,6,4,21,412
2024-04-14,161,73,57,11,6,4,21,291
2024-04-15,130,68,68,16,9,8,33,266
2024-04-16,138,85,69,11,7,5,23,292
2024-04-17,150,69,58,14,6,5,25,277
2024-04-18,188,84,53,14,6,4,24,325
2024-04-19,186,82,69,11,6,4,21,337
2024-04-20,205,89,82,11,5,4,20,376
2024-04-21,164,80,76,10,6,5,21,320
2024-04-22,136,80,67,14,8,6,28,283
2024-04-23,133,66,71,11,7,7,25,270
2024-04-24,147,68,67,13,6,6,25,282
2024-04-25,199,81,63,16,8,5,29,343
2024-04-26,195,84,80,13,6,5,24,359
2024-04-27,187,86,100,17,8,8,33,373
2024-04-28,148,78,69,9,6,5,20,295
2024-04-29,128,87,73,10,7,5,22,288
2024-04-30,145,69,92,12,5,7,24,306
2024-05-01,145,81,64,11,7,5,23,290
2024-05-02,193,92,71,15,9,6,30,356
2024-05-03,208,96,71,12,7,4,23,375
2024-05-04,210,112,84,11,8,5,24,406
2024-05-05,151,80,66,13,8,6,27,297
2024-05-06,136,91,65,12,9,6,27,292
2024-05-07,133,96,83,14,11,9,34,312
2024-05-08,156,92,52,15,9,5,29,300
2024-05-09,157,89,67,17,11,7,35,313
2024-05-10,206,81,70,12,5,4,21,357
2024-05-11,143,115,78,10,9,5,24,336
2024-05-12,148,71,63,11,6,5,22,282
2024-05-13,123,85,57,13,10,6,29,265
2024-05-14,141,83,60,12,8,5,25,284
2024-05-15,171,73,64,18,8,7,33,308
2024-05-16,184,99,69,18,11,7,36,352
2024-05-17,210,100,71,14,8,5,27,381
2024-05-18,203,110,83,12,7,5,24,396
2024-05-19,174,93,69,13,9,6,28,336
2024-05-20,137,100,56,16,13,7,36,293
2024-05-21,123,83,58,17,12,8,37,264
2024-05-22,150,122,57,10,10,4,24,329
2024-05-23,175,79,69,12,7,5,24,323
2024-05-24,201,85,73,12,6,5,23,359
2024-05-25,208,101,72,12,6,4,22,381
2024-05-26,152,82,65,10,6,5,21,299
2024-05-27,142,95,61,11,9,5,25,298
2024-05-28,153,86,63,13,8,5,26,302
2024-05-29,176,81,58,11,7,4,22,315
2024-05-30,163,78,67,14,7,6,27,308
2024-05-31,170,96,67,12,8,5,25,333
2024-06-01,208,104,72,13,8,5,26,384
2024-06-02,148,63,60,14,7,7,28,271
2024-06-03,109,93,56,15,14,7,36,258
2024-06-04,135,80,58,14,8,6,28,273
2024-06-05,152,91,56,16,10,5,31,299
2024-06-06,154,87,62,13,9,6,28,303
2024-06-07,184,103,64,15,9,5,29,351
2024-06-08,200,109,72,12,8,5,25,381
2024-06-09,139,91,63,13,10,6,29,293
2024-06-10,112,92,62,14,13,8,35,266
2024-06-11,146,88,62,14,10,6,30,296
2024-06-12,171,85,59,15,9,5,29,315
2024-06-13,169,83,65,15,9,6,30,317
2024-06-14,146,106,71,12,10,6,28,323
2024-06-15,170,99,67,11,7,4,22,336
2024-06-16,141,85,67,10,7,5,22,293
2024-06-17,142,95,56,12,10,5,27,293
2024-06-18,116,78,56,13,9,5,27,250
2024-06-19,176,76,64,13,6,4,23,316
2024-06-20,154,86,68,14,9,6,29,308
2024-06-21,176,106,70,14,9,6,29,352
2024-06-22,179,108,75,11,8,5,24,362
2024-06-23,152,93,71,9,7,5,21,316
2024-06-24,145,102,61,13,10,5,28,308
2024-06-25,133,92,74,13,9,7,29,299
2024-06-26,164,85,48,19,8,4,31,297
2024-06-27,174,82,66,15,7,6,28,322
2024-06-28,195,98,71,17,9,5,31,364
2024-06-29,197,93,69,13,7,5,25,359
2024-06-30,154,81,63,16,10,6,32,298
2024-07-01,148,78,57,18,10,7,35,283
2024-07-02,128,74,58,14,7,7,28,260
2024-07-03,162,85,56,14,7,5,26,303
2024-07-04,159,85,76,14,7,7,28,320
2024-07-05,171,95,68,12,8,5,25,334
2024-07-06,163,93,70,13,8,5,26,326
2024-07-07,190,82,64,13,5,4,22,336
2024-07-08,156,110,65,11,8,4,23,331
2024-07-09,188,104,62,12,7,4,23,354
2024-07-10,173,81,55,15,6,5,26,309
2024-07-11,201,87,69,20,8,7,35,357
2024-07-12,194,104,69,17,10,6,33,367
2024-07-13,199,85,69,13,6,5,24,353
2024-07-14,144,78,60,12,7,5,24,282
2024-07-15,151,82,64,14,8,5,27,297
2024-07-16,161,93,59,12,7,4,23,313
2024-07-17,168,85,56,15,6,5,26,309
2024-07-18,160,86,69,13,7,6,26,315
2024-07-19,172,94,70,13,7,5,25,336
2024-07-20,192,89,74,14,7,5,26,355
2024-07-21,160,79,63,13,7,5,25,302
2024-07-22,158,110,62,14,8,5,27,330
2024-07-23,141,98,64,14,9,6,29,303
2024-07-24,162,85,57,15,8,5,28,304
2024-07-25,154,78,68,15,8,7,30,300
2024-07-26,175,90,71,13,6,6,25,336
2024-07-27,177,91,76,12,6,5,23,344
2024-07-28,156,72,64,14,8,6,28,292
2024-07-29,149,96,65,13,9,6,28,310
2024-07-30,139,84,61,13,9,6,28,284
2024-07-31,165,120,55,16,13,5,34,340
2024-08-01,153,81,68,16,8,7,31,302
2024-08-02,180,89,69,14,6,5,25,338
2024-08-03,185,84,61,13,6,5,24,330
2024-08-04,166,78,64,12,7,5,24,308
2024-08-05,125,98,73,10,8,6,24,296
2024-08-06,147,80,57,14,8,5,27,284
2024-08-07,132,75,57,14,8,6,28,264
2024-08-08,158,81,60,12,7,5,24,299
2024-08-09,158,94,67,11,7,5,23,319
2024-08-10,176,93,70,13,7,5,25,339
2024-08-11,137,82,61,13,9,6,28,280
2024-08-12,118,82,54,12,9,5,26,254
2024-08-13,126,81,55,12,8,5,25,262
2024-08-14,121,78,56,12,9,5,26,255
2024-08-15,147,75,63,11,6,5,22,285
2024-08-16,158,85,65,11,6,5,22,308
2024-08-17,154,82,73,8,5,4,17,309
2024-08-18,158,76,58,14,8,5,27,292
2024-08-19,117,83,55,10,9,5,24,255
2024-08-20,114,81,57,14,10,7,31,252
2024-08-21,96,66,56,11,9,7,27,218
2024-08-22,141,74,66,12,7,6,25,281
2024-08-23,154,83,67,10,7,5,22,304
2024-08-24,164,82,65,10,6,4,20,311
2024-08-25,140,75,61,12,7,6,25,276
2024-08-26,118,70,56,11,8,5,24,244
2024-08-27,124,77,58,12,7,5,24,259
2024-08-28,125,87,55,12,9,6,27,267
2024-08-29,162,59,62,13,6,6,25,283
2024-08-30,169,78,67,12,7,5,24,314
2024-08-31,163,79,73,11,6,5,22,315
2024-09-01,116,66,57,11,7,6,24,239
2024-09-02,123,80,59,15,10,6,31,262
2024-09-03,105,64,57,19,11,10,40,226
2024-09-04,128,57,54,17,8,7,32,239
2024-09-05,157,76,62,13,8,6,27,295
2024-09-06,148,82,56,12,8,5,25,286
2024-09-07,199,80,73,13,6,5,24,352
2024-09-08,167,71,62,14,7,6,27,300
2024-09-09,139,73,58,20,11,8,39,270
2024-09-10,104,72,48,19,12,8,39,224
2024-09-11,106,75,58,15,10,8,33,239
2024-09-12,163,88,62,16,8,6,30,313
2024-09-13,171,84,69,12,7,5,24,324
2024-09-14,174,98,68,10,6,4,20,340
2024-09-15,132,75,65,11,7,5,23,272
2024-09-16,115,76,58,12,9,6,27,249
2024-09-17,96,81,59,11,10,7,28,236
2024-09-18,111,78,58,14,11,7,32,247
2024-09-19,146,80,64,13,8,6,27,290
2024-09-20,184,82,68,13,7,5,25,334
2024-09-21,171,97,75,10,7,5,22,343
2024-09-22,121,66,66,13,8,7,28,253
2024-09-23,116,75,60,12,8,6,26,251
2024-09-24,119,77,59,13,9,6,28,255
2024-09-25,124,87,58,12,8,5,25,269
2024-09-26,139,98,69,9,8,4,21,306
2024-09-27,178,94,72,12,7,5,24,344
2024-09-28,191,87,77,11,6,4,21,355
2024-09-29,126,67,66,11,7,6,24,259
2024-09-30,91,80,59,11,12,7,30,230
2024-10-01,130,80,58,15,10,7,32,268
2024-10-02,133,60,55,19,9,7,35,248
2024-10-03,144,85,66,11,9,6,26,295
2024-10-04,196,104,69,12,8,4,24,369
2024-10-05,173,82,71,9,6,4,19,326
2024-10-06,134,68,65,13,8,7,28,267
2024-10-07,112,79,60,14,12,8,34,251
2024-10-08,120,75,61,15,10,7,32,256
2024-10-09,119,74,55,16,10,7,33,248
2024-10-10,153,78,65,12,9,6,27,296
2024-10-11,175,85,68,13,8,5,26,328
2024-10-12,194,87,70,12,6,4,22,351
2024-10-13,138,60,65,13,6,6,25,263
2024-10-14,114,72,62,14,11,8,33,248
2024-10-15,122,65,60,16,9,7,32,247
2024-10-16,163,80,54,17,9,5,31,297
2024-10-17,164,74,63,13,7,5,25,301
2024-10-18,194,77,77,16,7,6,29,348
2024-10-19,198,86,70,12,6,4,22,354
2024-10-20,139,68,65,10,6,5,21,272
2024-10-21,129,88,62,11,9,6,26,279
2024-10-22,123,68,61,13,8,6,27,252
2024-10-23,117,72,56,11,8,5,24,245
2024-10-24,168,91,65,15,9,6,30,324
2024-10-25,181,75,69,13,6,5,24,325
2024-10-26,161,93,65,10,7,4,21,319
2024-10-27,128,75,66,9,7,5,21,269
2024-10-28,115,90,60,12,12,6,30,265
2024-10-29,125,77,60,14,9,7,30,262
2024-10-30,113,57,55,15,8,7,30,225
2024-10-31,157,87,66,13,9,6,28,310
2024-11-01,169,94,65,10,7,4,21,328
2024-11-02,179,94,80,10,6,4,20,353
2024-11-03,151,66,65,12,7,6,25,282
2024-11-04,85,82,57,12,14,8,34,224
2024-11-05,107,66,56,14,9,7,30,229
2024-11-06,98,62,57,14,9,8,31,217
2024-11-07,131,78,61,15,11,7,33,270
2024-11-08,173,96,65,12,8,5,25,334
2024-11-09,162,95,76,10,7,5,22,333
2024-11-10,131,76,63,9,7,5,21,270
2024-11-11,94,67,56,16,14,9,39,217
2024-11-12,103,63,56,18,11,9,38,222
2024-11-13,94,56,55,15,9,9,33,205
2024-11-14,123,77,57,16,12,8,36,257
2024-11-15,176,92,61,12,7,4,23,329
2024-11-16,186,97,69,12,7,5,24,352
2024-11-17,135,75,61,14,9,6,29,271
2024-11-18,81,69,59,11,11,8,30,209
2024-11-19,110,77,59,14,10,7,31,246
2024-11-20,117,72,56,16,10,7,33,245
2024-11-21,143,67,62,14,7,6,27,272
2024-11-22,190,92,64,15,8,5,28,346
2024-11-23,199,92,71,13,7,4,24,362
2024-11-24,111,73,63,11,8,6,25,247
2024-11-25,83,59,54,19,16,12,47,196
2024-11-26,96,57,54,19,12,10,41,207
2024-11-27,80,56,49,14,10,8,32,185
2024-11-28,134,67,61,17,10,7,34,262
2024-11-29,164,88,67,13,8,6,27,319
2024-11-30,188,90,73,11,6,4,21,351
2024-12-01,120,63,61,13,8,6,27,244
2024-12-02,88,57,54,19,14,11,44,199
2024-12-03,70,47,53,14,10,10,34,170
2024-12-04,74,60,49,15,13,10,38,183
2024-12-05,122,60,58,20,11,9,40,240
2024-12-06,156,66,65,13,7,6,26,287
2024-12-07,181,76,71,12,6,5,23,328
2024-12-08,116,60,59,12,8,7,27,235
2024-12-09,84,61,52,21,17,12,50,197
2024-12-10,104,73,54,21,19,11,51,231
2024-12-11,63,47,52,13,11,10,34,162
2024-12-12,160,67,59,13,7,5,25,286
2024-12-13,167,72,64,13,7,5,25,303
2024-12-14,190,80,71,14,7,5,26,341
2024-12-15,87,78,59,11,12,8,31,224
2024-12-16,76,60,53,13,12,9,34,189
2024-12-17,77,55,49,12,9,7,28,181
2024-12-18,85,50,48,12,9,7,28,183
2024-12-19,120,59,64,18,11,10,39,243
2024-12-20,144,76,58,15,9,6,30,278
2024-12-21,159,68,67,12,6,6,24,294
2024-12-22,115,63,56,11,7,5,23,234
2024-12-23,121,53,54,14,7,7,28,228
2024-12-24,132,72,60,12,8,5,25,264
2024-12-25,159,89,66,17,11,6,34,314
2024-12-26,184,79,64,20,10,7,37,327
2024-12-27,168,78,64,13,7,5,25,310
2024-12-28,170,89,67,10,6,4,20,326
2024-12-29,147,80,58,10,7,4,21,285
2024-12-30,107,73,46,9,7,4,20,226
2024-12-31,198,78,64,11,5,3,19,340
2025-01-01,104,83,50,17,15,7,39,237
2025-01-02,170,70,50,13,6,4,23,290
2025-01-03,157,78,53,12,7,4,23,288
2025-01-04,151,83,56,13,9,5,27,290
2025-01-05,103,57,51,17,11,9,37,211
2025-01-06,51,48,36,19,21,13,53,135
2025-01-07,56,44,39,13,13,9,35,139
2025-01-08,58,46,38,14,13,9,36,142
2025-01-09,108,62,45,30,20,12,62,215
2025-01-10,165,55,55,21,9,7,37,275
2025-01-11,168,71,55,14,7,5,26,294
2025-01-12,101,56,46,18,12,8,38,203
2025-01-13,69,56,37,18,16,9,43,162
2025-01-14,60,46,41,17,16,12,45,147
2025-01-15,51,53,37,16,19,11,46,141
2025-01-16,96,66,47,18,15,8,41,209
2025-01-17,151,67,55,18,9,6,33,273
2025-01-18,159,70,57,13,6,4,23,286
2025-01-19,102,56,48,14,8,6,28,206
2025-01-20,114,73,37,16,11,5,32,224
2025-01-21,51,61,57,14,20,15,49,169
2025-01-22,65,63,37,27,30,14,71,165
2025-01-23,87,57,47,12,9,6,27,191
2025-01-24,162,58,56,17,6,5,28,276
2025-01-25,173,71,56,14,6,4,24,300
2025-01-26,98,61,50,16,10,8,34,209
2025-01-27,56,53,58,11,11,11,33,167
2025-01-28,58,50,44,15,15,11,41,152
2025-01-29,52,45,34,9,9,6,24,131
2025-01-30,106,57,40,14,8,5,27,203
2025-01-31,130,71,59,14,8,6,28,260
2025-02-01,152,83,54,11,6,4,21,289
2025-02-02,110,57,50,16,8,7,31,217
2025-02-03,73,51,38,21,15,10,46,162
2025-02-04,50,57,39,14,18,10,42,146
2025-02-05,52,44,44,12,12,10,34,140
2025-02-06,118,53,40,16,8,5,29,211
2025-02-07,134,69,57,16,9,6,31,260
2025-02-08,154,74,50,14,7,4,25,278
2025-02-09,111,60,50,11,6,5,22,221
2025-02-10,105,59,46,15,10,6,31,210
2025-02-11,80,61,38,12,11,6,29,179
2025-02-12,96,65,51,11,9,6,26,212
2025-02-13,122,63,50,18,11,7,36,235
2025-02-14,188,97,61,12,6,4,22,346
2025-02-15,167,81,65,12,6,5,23,313
2025-02-16,89,52,49,12,7,6,25,190
2025-02-17,66,56,57,15,13,11,39,179
2025-02-18,70,52,40,13,11,7,31,162
2025-02-19,76,39,40,14,9,8,31,155
2025-02-20,96,70,32,15,13,5,33,198
2025-02-21,144,82,48,13,9,4,26,274
2025-02-22,143,75,37,12,7,3,22,255
2025-02-23,85,52,42,14,10,7,31,179
2025-02-24,71,45,30,24,18,10,52,146
2025-02-25,61,66,39,13,16,8,37,166
2025-02-26,61,48,43,12,11,8,31,152
2025-02-27,110,62,35,20,15,6,41,207
2025-02-28,126,79,50,13,8,5,26,255
2025-03-01,154,80,51,12,6,4,22,285
2025-03-02,108,73,32,10,7,3,20,213
2025-03-03,95,56,46,22,13,10,45,197
2025-03-04,76,48,45,16,11,9,36,169
2025-03-05,77,45,33,18,12,8,38,155
2025-03-06,102,68,40,16,12,6,34,210
2025-03-07,147,59,57,16,7,5,28,263
2025-03-08,152,85,56,12,7,4,23,293
2025-03-09,92,61,41,11,8,5,24,194
2025-03-10,89,61,43,13,9,6,28,193
2025-03-11,72,80,51,12,15,8,35,203
2025-03-12,72,67,43,12,13,7,32,182
2025-03-13,114,65,42,15,10,6,31,221
2025-03-14,166,69,54,15,7,5,27,289
2025-03-15,179,83,64,13,6,4,23,326
2025-03-16,109,60,46,12,7,5,24,215
2025-03-17,97,73,50,15,12,7,34,220
2025-03-18,65,51,58,12,10,10,32,174
2025-03-19,120,85,47,12,9,5,26,252
2025-03-20,116,70,48,11,8,5,24,234
2025-03-21,152,85,49,12,7,4,23,286
2025-03-22,180,86,54,11,6,3,20,320
2025-03-23,135,64,37,15,8,4,27,236
2025-03-24,90,69,50,12,10,6,28,209
2025-03-25,76,68,52,12,12,8,32,196
2025-03-26,77,60,54,13,11,9,33,191
2025-03-27,104,73,52,14,11,7,32,229
2025-03-28,153,80,60,12,6,4,22,293
2025-03-29,169,90,62,12,7,4,23,321
2025-03-30,99,73,47,8,7,4,19,219
2025-03-31,95,69,49,9,7,4,20,213
2025-04-01,87,71,32,10,8,3,21,190
2025-04-02,87,75,58,8,8,5,21,220
2025-04-03,137,77,64,13,8,6,27,278
2025-04-04,183,77,66,13,6,5,24,326
2025-04-05,167,93,63,11,6,4,21,323
2025-04-06,136,83,64,13,8,6,27,283
2025-04-07,104,74,56,10,8,5,23,234
2025-04-08,120,87,56,12,9,5,26,263
2025-04-09,110,74,53,10,7,5,22,237
2025-04-10,142,80,56,14,9,5,28,278
2025-04-11,178,86,72,12,6,5,23,336
2025-04-12,224,94,75,13,5,4,22,393
2025-04-13,146,75,65,11,7,5,23,286
2025-04-14,121,105,59,11,11,5,27,285
2025-04-15,115,76,66,10,7,6,23,257
2025-04-16,91,71,55,8,7,5,20,217
2025-04-17,159,87,58,12,7,4,23,304
2025-04-18,193,93,73,11,6,4,21,359
2025-04-19,192,105,70,10,6,4,20,367
2025-04-20,181,87,56,13,7,4,24,324
2025-04-21,204,95,62,22,11,6,39,361
2025-04-22,115,74,63,11,7,6,24,252
2025-04-23,89,70,51,8,7,5,20,210
2025-04-24,123,97,61,9,8,5,22,281
2025-04-25,166,94,67,11,6,4,21,327
2025-04-26,127,83,72,18,12,10,40,282
2025-04-27,128,75,51,11,7,4,22,254
2025-04-28,126,74,55,13,8,5,26,255
2025-04-29,166,62,55,18,7,6,31,283
2025-04-30,92,85,57,8,6,5,19,234
2025-05-01,147,92,63,10,7,4,21,302
2025-05-02,166,104,66,10,7,4,21,336
2025-05-03,185,103,67,11,7,4,22,355
2025-05-04,123,81,54,9,6,4,19,258
2025-05-05,150,86,61,18,12,7,37,297
2025-05-06,117,69,56,15,10,7,32,242
2025-05-07,120,65,59,14,9,7,30,244
2025-05-08,125,85,64,9,8,4,21,274
2025-05-09,196,92,57,14,7,4,25,345
2025-05-10,217,92,70,13,7,4,24,379
2025-05-11,168,75,58,12,7,4,23,301
2025-05-12,144,65,55,14,7,5,26,264
2025-05-13,114,76,56,13,9,6,28,246
2025-05-14,98,79,57,11,9,6,26,234
2025-05-15,142,88,76,15,10,8,33,306
2025-05-16,180,107,78,13,8,5,26,365
2025-05-17,201,118,83,11,7,4,22,402
2025-05-18,173,106,67,9,7,4,20,346
2025-05-19,157,86,54,12,7,4,23,297
2025-05-20,130,77,60,11,6,5,22,267
2025-05-21,117,82,61,12,9,6,27,260
2025-05-22,165,97,56,14,9,5,28,318
2025-05-23,172,98,60,13,8,4,25,330
2025-05-24,161,96,67,11,7,4,22,324
2025-05-25,111,87,55,10,9,5,24,253
2025-05-26,127,75,68,13,9,7,29,270
2025-05-27,117,69,56,16,10,8,34,242
2025-05-28,118,82,58,13,10,7,30,258
2025-05-29,150,100,55,14,11,5,30,305
2025-05-30,189,106,50,11,7,3,21,345
2025-05-31,153,90,60,11,7,4,22,303
